,영화명,개봉일,점유율집계일,개봉n일차(int),상영횟수,스크린수,좌석수,좌석판매율,매출액,누적매출액,관객수,누적관객수,F-rated,장르,배급사,감독1성별,작가성별,배우성별,F등급
0,조선명탐정 : 사라진 놉의 딸,2015-02-11,2015-02-02,-9,4,4,869,100.0,6083000,6083000,869,869,1,"사극,코미디,어드벤처",(주)쇼박스,남자,여자,남자,1
1,조선명탐정 : 사라진 놉의 딸,2015-02-11,2015-02-03,-8,9,9,2025,100.0,18225000,24308000,2025,2894,1,"사극,코미디,어드벤처",(주)쇼박스,남자,여자,남자,1
2,조선명탐정 : 사라진 놉의 딸,2015-02-11,2015-02-04,-7,14,14,2972,97.4,23160000,47468000,2895,5789,1,"사극,코미디,어드벤처",(주)쇼박스,남자,여자,남자,1
3,조선명탐정 : 사라진 놉의 딸,2015-02-11,2015-02-05,-6,7,7,2425,99.5,16891000,64359000,2413,8202,1,"사극,코미디,어드벤처",(주)쇼박스,남자,여자,남자,1
4,조선명탐정 : 사라진 놉의 딸,2015-02-11,2015-02-11,0,3670,740,762037,14.9,853823300,918182300,113443,121645,1,"사극,코미디,어드벤처",(주)쇼박스,남자,여자,남자,1
5,조선명탐정 : 사라진 놉의 딸,2015-02-11,2015-02-12,1,3741,766,771903,14.3,825063900,1743246200,110284,231929,1,"사극,코미디,어드벤처",(주)쇼박스,남자,여자,남자,1
6,조선명탐정 : 사라진 놉의 딸,2015-02-11,2015-02-13,2,3889,769,802301,17.2,1097163581,2840409781,137631,369560,1,"사극,코미디,어드벤처",(주)쇼박스,남자,여자,남자,1
7,조선명탐정 : 사라진 놉의 딸,2015-02-11,2015-02-14,3,4111,811,850010,37.9,2604862268,5445272049,322022,691582,1,"사극,코미디,어드벤처",(주)쇼박스,남자,여자,남자,1
8,조선명탐정 : 사라진 놉의 딸,2015-02-11,2015-02-15,4,3985,810,828623,32.6,2147212100,7592484149,269925,961507,1,"사극,코미디,어드벤처",(주)쇼박스,남자,여자,남자,1
9,조선명탐정 : 사라진 놉의 딸,2015-02-11,2015-02-16,5,3727,751,778462,12.6,728943900,8321428049,97742,1059249,1,"사극,코미디,어드벤처",(주)쇼박스,남자,여자,남자,1
10,조선명탐정 : 사라진 놉의 딸,2015-02-11,2015-02-17,6,3812,746,793595,18.7,1120622200,9442050249,148087,1207336,1,"사극,코미디,어드벤처",(주)쇼박스,남자,여자,남자,1
11,조선명탐정 : 사라진 놉의 딸,2015-02-11,2015-02-18,7,4183,804,879892,33.7,2407918800,11849969049,296713,1504049,1,"사극,코미디,어드벤처",(주)쇼박스,남자,여자,남자,1
12,조선명탐정 : 사라진 놉의 딸,2015-02-11,2015-02-19,8,4184,825,880052,50.2,3644633700,15494602749,441844,1945893,1,"사극,코미디,어드벤처",(주)쇼박스,남자,여자,남자,1
13,조선명탐정 : 사라진 놉의 딸,2015-02-11,2015-02-20,9,4167,813,871153,57.1,3972232188,19466834937,497065,2442958,1,"사극,코미디,어드벤처",(주)쇼박스,남자,여자,남자,1
14,조선명탐정 : 사라진 놉의 딸,2015-02-11,2015-02-21,10,4136,817,859910,49.5,3383603091,22850438028,425279,2868237,1,"사극,코미디,어드벤처",(주)쇼박스,남자,여자,남자,1
15,조선명탐정 : 사라진 놉의 딸,2015-02-11,2015-02-22,11,3921,804,815260,34.8,2237192500,25087630528,283431,3151668,1,"사극,코미디,어드벤처",(주)쇼박스,남자,여자,남자,1
16,조선명탐정 : 사라진 놉의 딸,2015-02-11,2015-02-23,12,3477,706,713989,10.2,532721300,25620351828,72837,3224505,1,"사극,코미디,어드벤처",(주)쇼박스,남자,여자,남자,1
17,조선명탐정 : 사라진 놉의 딸,2015-02-11,2015-02-24,13,3441,720,704441,9.4,479962500,26100314328,66290,3290795,1,"사극,코미디,어드벤처",(주)쇼박스,남자,여자,남자,1
18,조선명탐정 : 사라진 놉의 딸,2015-02-11,2015-02-25,14,2883,666,582540,12.0,452136500,26552450828,70091,3360886,1,"사극,코미디,어드벤처",(주)쇼박스,남자,여자,남자,1
19,조선명탐정 : 사라진 놉의 딸,2015-02-11,2015-02-26,15,2128,472,411031,12.1,358879000,26911329828,49726,3410612,1,"사극,코미디,어드벤처",(주)쇼박스,남자,여자,남자,1
20,조선명탐정 : 사라진 놉의 딸,2015-02-11,2015-02-27,16,2192,479,423164,13.3,429177500,27340507328,56335,3466947,1,"사극,코미디,어드벤처",(주)쇼박스,남자,여자,남자,1
21,조선명탐정 : 사라진 놉의 딸,2015-02-11,2015-02-28,17,2228,502,426387,27.4,910341400,28250848728,116719,3583666,1,"사극,코미디,어드벤처",(주)쇼박스,남자,여자,남자,1
22,조선명탐정 : 사라진 놉의 딸,2015-02-11,2015-03-01,18,2132,503,407499,23.2,750487500,29001336228,94690,3678356,1,"사극,코미디,어드벤처",(주)쇼박스,남자,여자,남자,1
23,조선명탐정 : 사라진 놉의 딸,2015-02-11,2015-03-02,19,1908,447,350960,6.7,170882500,29172218728,23392,3701748,1,"사극,코미디,어드벤처",(주)쇼박스,남자,여자,남자,1
24,조선명탐정 : 사라진 놉의 딸,2015-02-11,2015-03-03,20,1902,444,352802,6.2,159864400,29332083128,21998,3723746,1,"사극,코미디,어드벤처",(주)쇼박스,남자,여자,남자,1
25,조선명탐정 : 사라진 놉의 딸,2015-02-11,2015-03-04,21,1865,432,343779,5.2,131698200,29463781328,17866,3741612,1,"사극,코미디,어드벤처",(주)쇼박스,남자,여자,남자,1
26,조선명탐정 : 사라진 놉의 딸,2015-02-11,2015-03-05,22,1097,356,160802,6.2,71966600,29535747928,9960,3751572,1,"사극,코미디,어드벤처",(주)쇼박스,남자,여자,남자,1
27,조선명탐정 : 사라진 놉의 딸,2015-02-11,2015-03-06,23,1149,362,167074,7.7,99762300,29635510228,12796,3764368,1,"사극,코미디,어드벤처",(주)쇼박스,남자,여자,남자,1
28,조선명탐정 : 사라진 놉의 딸,2015-02-11,2015-03-07,24,1150,397,164959,22.3,288680800,29924191028,36759,3801127,1,"사극,코미디,어드벤처",(주)쇼박스,남자,여자,남자,1
29,조선명탐정 : 사라진 놉의 딸,2015-02-11,2015-03-08,25,1091,389,157338,20.2,248475300,30172666328,31771,3832898,1,"사극,코미디,어드벤처",(주)쇼박스,남자,여자,남자,1
30,조선명탐정 : 사라진 놉의 딸,2015-02-11,2015-03-09,26,953,334,135587,5.4,53472400,30226138728,7289,3840187,1,"사극,코미디,어드벤처",(주)쇼박스,남자,여자,남자,1
31,조선명탐정 : 사라진 놉의 딸,2015-02-11,2015-03-10,27,960,332,136221,5.3,52439500,30278578228,7171,3847358,1,"사극,코미디,어드벤처",(주)쇼박스,남자,여자,남자,1
32,조선명탐정 : 사라진 놉의 딸,2015-02-11,2015-03-11,28,973,339,138012,5.8,56813100,30335391328,8062,3855420,1,"사극,코미디,어드벤처",(주)쇼박스,남자,여자,남자,1
33,조선명탐정 : 사라진 놉의 딸,2015-02-11,2015-03-12,29,211,141,27132,5.0,9510200,30344901528,1344,3856764,1,"사극,코미디,어드벤처",(주)쇼박스,남자,여자,남자,1
34,조선명탐정 : 사라진 놉의 딸,2015-02-11,2015-03-13,30,215,134,27561,6.0,12244500,30357146028,1639,3858403,1,"사극,코미디,어드벤처",(주)쇼박스,남자,여자,남자,1
35,조선명탐정 : 사라진 놉의 딸,2015-02-11,2015-03-14,31,208,146,26982,17.3,35589800,30392735828,4675,3863078,1,"사극,코미디,어드벤처",(주)쇼박스,남자,여자,남자,1
36,조선명탐정 : 사라진 놉의 딸,2015-02-11,2015-03-15,32,194,140,24614,16.8,31876800,30424612628,4131,3867209,1,"사극,코미디,어드벤처",(주)쇼박스,남자,여자,남자,1
37,조선명탐정 : 사라진 놉의 딸,2015-02-11,2015-03-16,33,176,123,23610,6.2,9710400,30434323028,1465,3868674,1,"사극,코미디,어드벤처",(주)쇼박스,남자,여자,남자,1
38,조선명탐정 : 사라진 놉의 딸,2015-02-11,2015-03-17,34,166,120,21606,4.5,6839400,30441162428,964,3869638,1,"사극,코미디,어드벤처",(주)쇼박스,남자,여자,남자,1
39,조선명탐정 : 사라진 놉의 딸,2015-02-11,2015-03-18,35,182,123,24171,5.1,8677000,30449839428,1222,3870860,1,"사극,코미디,어드벤처",(주)쇼박스,남자,여자,남자,1
40,조선명탐정 : 사라진 놉의 딸,2015-02-11,2015-03-19,36,9,6,1112,6.1,422000,30450261428,68,3870928,1,"사극,코미디,어드벤처",(주)쇼박스,남자,여자,남자,1
41,조선명탐정 : 사라진 놉의 딸,2015-02-11,2015-03-20,37,11,9,1621,7.4,710000,30450971428,120,3871048,1,"사극,코미디,어드벤처",(주)쇼박스,남자,여자,남자,1
42,조선명탐정 : 사라진 놉의 딸,2015-02-11,2015-03-21,38,9,6,946,23.0,1348000,30452319428,218,3871266,1,"사극,코미디,어드벤처",(주)쇼박스,남자,여자,남자,1
43,조선명탐정 : 사라진 놉의 딸,2015-02-11,2015-03-22,39,8,5,861,6.6,420000,30452739428,57,3871323,1,"사극,코미디,어드벤처",(주)쇼박스,남자,여자,남자,1
44,조선명탐정 : 사라진 놉의 딸,2015-02-11,2015-03-23,40,5,3,498,3.6,126000,30452865428,18,3871341,1,"사극,코미디,어드벤처",(주)쇼박스,남자,여자,남자,1
45,조선명탐정 : 사라진 놉의 딸,2015-02-11,2015-03-24,41,9,6,1043,13.8,674000,30453539428,144,3871485,1,"사극,코미디,어드벤처",(주)쇼박스,남자,여자,남자,1
46,조선명탐정 : 사라진 놉의 딸,2015-02-11,2015-03-25,42,4,4,656,66.3,2770000,30456309428,435,3871920,1,"사극,코미디,어드벤처",(주)쇼박스,남자,여자,남자,1
47,조선명탐정 : 사라진 놉의 딸,2015-02-11,2015-03-27,44,1,1,94,101.1,570000,30456879428,95,3872015,1,"사극,코미디,어드벤처",(주)쇼박스,남자,여자,남자,1
48,조선명탐정 : 사라진 놉의 딸,2015-02-11,2015-05-09,87,1,1,306,0.0,0,30456879428,0,3872015,1,"사극,코미디,어드벤처",(주)쇼박스,남자,여자,남자,1
49,조선명탐정 : 사라진 놉의 딸,2015-02-11,2015-05-10,88,1,1,389,0.0,0,30456879428,0,3872015,1,"사극,코미디,어드벤처",(주)쇼박스,남자,여자,남자,1
50,스물,2015-03-25,2015-03-04,-21,1,1,183,100.0,1464000,1464000,183,183,0,"코미디,드라마",(주)넥스트엔터테인먼트월드(NEW),남자,남자,남자,0
51,스물,2015-03-25,2015-03-09,-16,1,1,326,100.0,1956000,3420000,326,509,0,"코미디,드라마",(주)넥스트엔터테인먼트월드(NEW),남자,남자,남자,0
52,스물,2015-03-25,2015-03-12,-13,22,22,4238,100.0,34636000,38056000,4238,4747,0,"코미디,드라마",(주)넥스트엔터테인먼트월드(NEW),남자,남자,남자,0
53,스물,2015-03-25,2015-03-13,-12,26,26,5353,98.9,44877000,82933000,5295,10042,0,"코미디,드라마",(주)넥스트엔터테인먼트월드(NEW),남자,남자,남자,0
54,스물,2015-03-25,2015-03-14,-11,3,3,747,92.9,6246000,89179000,694,10736,0,"코미디,드라마",(주)넥스트엔터테인먼트월드(NEW),남자,남자,남자,0
55,스물,2015-03-25,2015-03-16,-9,17,17,3447,5.3,1464000,90643000,183,10919,0,"코미디,드라마",(주)넥스트엔터테인먼트월드(NEW),남자,남자,남자,0
56,스물,2015-03-25,2015-03-17,-8,58,58,9245,2.8,2040000,92683000,255,11174,0,"코미디,드라마",(주)넥스트엔터테인먼트월드(NEW),남자,남자,남자,0
57,스물,2015-03-25,2015-03-18,-7,12,12,3563,99.7,27958000,120641000,3551,14725,0,"코미디,드라마",(주)넥스트엔터테인먼트월드(NEW),남자,남자,남자,0
58,스물,2015-03-25,2015-03-20,-5,3,3,622,100.0,5598000,126239000,622,15347,0,"코미디,드라마",(주)넥스트엔터테인먼트월드(NEW),남자,남자,남자,0
59,스물,2015-03-25,2015-03-23,-2,5,5,1039,100.0,8312000,134551000,1039,16386,0,"코미디,드라마",(주)넥스트엔터테인먼트월드(NEW),남자,남자,남자,0
60,스물,2015-03-25,2015-03-24,-1,19,19,4500,47.0,22258500,156809500,2115,18501,0,"코미디,드라마",(주)넥스트엔터테인먼트월드(NEW),남자,남자,남자,0
61,스물,2015-03-25,2015-03-25,0,4212,786,860168,17.6,981625100,1138434600,151161,169662,0,"코미디,드라마",(주)넥스트엔터테인먼트월드(NEW),남자,남자,남자,0
62,스물,2015-03-25,2015-03-26,1,4500,829,904696,12.6,860554400,1998989000,114294,283956,0,"코미디,드라마",(주)넥스트엔터테인먼트월드(NEW),남자,남자,남자,0
63,스물,2015-03-25,2015-03-27,2,4667,831,936813,17.1,1268802316,3267791316,160114,444070,0,"코미디,드라마",(주)넥스트엔터테인먼트월드(NEW),남자,남자,남자,0
64,스물,2015-03-25,2015-03-28,3,5165,926,1032402,34.7,2826752303,6094543619,358084,802154,0,"코미디,드라마",(주)넥스트엔터테인먼트월드(NEW),남자,남자,남자,0
65,스물,2015-03-25,2015-03-29,4,5011,910,1000689,33.5,2652125100,8746668719,334969,1137123,0,"코미디,드라마",(주)넥스트엔터테인먼트월드(NEW),남자,남자,남자,0
66,스물,2015-03-25,2015-03-30,5,4572,840,893897,12.0,809086100,9555754819,107313,1244436,0,"코미디,드라마",(주)넥스트엔터테인먼트월드(NEW),남자,남자,남자,0
67,스물,2015-03-25,2015-03-31,6,4614,857,900918,11.9,805211100,10360965919,107402,1351838,0,"코미디,드라마",(주)넥스트엔터테인먼트월드(NEW),남자,남자,남자,0
68,스물,2015-03-25,2015-04-01,7,3860,736,663750,18.7,922388300,11283354219,123777,1475615,0,"코미디,드라마",(주)넥스트엔터테인먼트월드(NEW),남자,남자,남자,0
69,스물,2015-03-25,2015-04-02,8,3740,729,644683,12.7,618857300,11902211519,81943,1557558,0,"코미디,드라마",(주)넥스트엔터테인먼트월드(NEW),남자,남자,남자,0
70,스물,2015-03-25,2015-04-03,9,3880,760,665396,19.4,1024870928,12927082447,128837,1686395,0,"코미디,드라마",(주)넥스트엔터테인먼트월드(NEW),남자,남자,남자,0
71,스물,2015-03-25,2015-04-04,10,4155,786,723877,38.3,2191462613,15118545060,277145,1963540,0,"코미디,드라마",(주)넥스트엔터테인먼트월드(NEW),남자,남자,남자,0
72,스물,2015-03-25,2015-04-05,11,4055,791,707859,33.7,1894169900,17012714960,238630,2202170,0,"코미디,드라마",(주)넥스트엔터테인먼트월드(NEW),남자,남자,남자,0
73,스물,2015-03-25,2015-04-06,12,3735,729,625005,10.4,489133300,17501848260,64877,2267047,0,"코미디,드라마",(주)넥스트엔터테인먼트월드(NEW),남자,남자,남자,0
74,스물,2015-03-25,2015-04-07,13,3710,731,621533,9.0,417011000,17918859260,55648,2322695,0,"코미디,드라마",(주)넥스트엔터테인먼트월드(NEW),남자,남자,남자,0
75,스물,2015-03-25,2015-04-08,14,3570,708,597821,8.6,384916700,18303775960,51091,2373786,0,"코미디,드라마",(주)넥스트엔터테인먼트월드(NEW),남자,남자,남자,0
76,스물,2015-03-25,2015-04-09,15,2895,661,465512,10.2,353321100,18657097060,47346,2421132,0,"코미디,드라마",(주)넥스트엔터테인먼트월드(NEW),남자,남자,남자,0
77,스물,2015-03-25,2015-04-10,16,2876,658,455435,14.3,511320200,19168417260,64981,2486113,0,"코미디,드라마",(주)넥스트엔터테인먼트월드(NEW),남자,남자,남자,0
78,스물,2015-03-25,2015-04-11,17,3034,651,488076,25.9,1006056600,20174473860,126580,2612693,0,"코미디,드라마",(주)넥스트엔터테인먼트월드(NEW),남자,남자,남자,0
79,스물,2015-03-25,2015-04-12,18,2914,637,465688,21.9,820866500,20995340360,102143,2714836,0,"코미디,드라마",(주)넥스트엔터테인먼트월드(NEW),남자,남자,남자,0
80,스물,2015-03-25,2015-04-13,19,2545,551,393148,7.4,221973500,21217313860,29077,2743913,0,"코미디,드라마",(주)넥스트엔터테인먼트월드(NEW),남자,남자,남자,0
81,스물,2015-03-25,2015-04-14,20,2511,547,388433,6.9,201782700,21419096560,26604,2770517,0,"코미디,드라마",(주)넥스트엔터테인먼트월드(NEW),남자,남자,남자,0
82,스물,2015-03-25,2015-04-15,21,2435,541,377297,6.5,185364700,21604461260,24467,2794984,0,"코미디,드라마",(주)넥스트엔터테인먼트월드(NEW),남자,남자,남자,0
83,스물,2015-03-25,2015-04-16,22,2164,479,325645,6.8,166616800,21771078060,22089,2817073,0,"코미디,드라마",(주)넥스트엔터테인먼트월드(NEW),남자,남자,남자,0
84,스물,2015-03-25,2015-04-17,23,2287,497,341166,9.3,250173266,22021251326,31770,2848843,0,"코미디,드라마",(주)넥스트엔터테인먼트월드(NEW),남자,남자,남자,0
85,스물,2015-03-25,2015-04-18,24,2445,520,373605,16.2,491011360,22512262686,60636,2909479,0,"코미디,드라마",(주)넥스트엔터테인먼트월드(NEW),남자,남자,남자,0
86,스물,2015-03-25,2015-04-19,25,2362,517,361370,15.2,451945400,22964208086,55018,2964497,0,"코미디,드라마",(주)넥스트엔터테인먼트월드(NEW),남자,남자,남자,0
87,스물,2015-03-25,2015-04-20,26,2080,478,309317,5.5,127535200,23091743286,16946,2981443,0,"코미디,드라마",(주)넥스트엔터테인먼트월드(NEW),남자,남자,남자,0
88,스물,2015-03-25,2015-04-21,27,1991,484,294386,5.0,110178300,23201921586,14731,2996174,0,"코미디,드라마",(주)넥스트엔터테인먼트월드(NEW),남자,남자,남자,0
89,스물,2015-03-25,2015-04-22,28,1984,476,294768,5.1,113853100,23315774686,15078,3011252,0,"코미디,드라마",(주)넥스트엔터테인먼트월드(NEW),남자,남자,남자,0
90,스물,2015-03-25,2015-04-23,29,317,175,36853,8.8,24195600,23339970286,3245,3014497,0,"코미디,드라마",(주)넥스트엔터테인먼트월드(NEW),남자,남자,남자,0
91,스물,2015-03-25,2015-04-24,30,310,177,36660,15.1,42464700,23382434986,5543,3020040,0,"코미디,드라마",(주)넥스트엔터테인먼트월드(NEW),남자,남자,남자,0
92,스물,2015-03-25,2015-04-25,31,235,144,27748,22.4,48892900,23431327886,6211,3026251,0,"코미디,드라마",(주)넥스트엔터테인먼트월드(NEW),남자,남자,남자,0
93,스물,2015-03-25,2015-04-26,32,223,148,26296,19.8,41256300,23472584186,5215,3031466,0,"코미디,드라마",(주)넥스트엔터테인먼트월드(NEW),남자,남자,남자,0
94,스물,2015-03-25,2015-04-27,33,287,166,33350,7.3,17949000,23490533186,2440,3033906,0,"코미디,드라마",(주)넥스트엔터테인먼트월드(NEW),남자,남자,남자,0
95,스물,2015-03-25,2015-04-28,34,295,168,34785,9.7,24316000,23514849186,3357,3037263,0,"코미디,드라마",(주)넥스트엔터테인먼트월드(NEW),남자,남자,남자,0
96,스물,2015-03-25,2015-04-29,35,88,63,10329,14.0,9756700,23524605886,1445,3038708,0,"코미디,드라마",(주)넥스트엔터테인먼트월드(NEW),남자,남자,남자,0
97,스물,2015-03-25,2015-04-30,36,19,16,2264,31.9,3778500,23528384386,723,3039431,0,"코미디,드라마",(주)넥스트엔터테인먼트월드(NEW),남자,남자,남자,0
98,스물,2015-03-25,2015-05-01,37,15,13,1507,33.6,3693500,23532077886,507,3039938,0,"코미디,드라마",(주)넥스트엔터테인먼트월드(NEW),남자,남자,남자,0
99,스물,2015-03-25,2015-05-02,38,18,13,1701,36.6,4369800,23536447686,622,3040560,0,"코미디,드라마",(주)넥스트엔터테인먼트월드(NEW),남자,남자,남자,0
100,스물,2015-03-25,2015-05-03,39,16,12,1625,30.0,3631000,23540078686,487,3041047,0,"코미디,드라마",(주)넥스트엔터테인먼트월드(NEW),남자,남자,남자,0
101,스물,2015-03-25,2015-05-04,40,21,18,2415,31.0,4406500,23544485186,749,3041796,0,"코미디,드라마",(주)넥스트엔터테인먼트월드(NEW),남자,남자,남자,0
102,스물,2015-03-25,2015-05-05,41,15,11,1736,25.5,3207000,23547692186,442,3042238,0,"코미디,드라마",(주)넥스트엔터테인먼트월드(NEW),남자,남자,남자,0
103,스물,2015-03-25,2015-05-06,42,23,20,3096,8.4,1413000,23549105186,261,3042499,0,"코미디,드라마",(주)넥스트엔터테인먼트월드(NEW),남자,남자,남자,0
104,스물,2015-03-25,2015-05-07,43,14,12,1955,7.1,788000,23549893186,138,3042637,0,"코미디,드라마",(주)넥스트엔터테인먼트월드(NEW),남자,남자,남자,0
105,스물,2015-03-25,2015-05-08,44,14,13,1977,4.8,597000,23550490186,94,3042731,0,"코미디,드라마",(주)넥스트엔터테인먼트월드(NEW),남자,남자,남자,0
106,스물,2015-03-25,2015-05-09,45,13,11,1817,7.1,803500,23551293686,129,3042860,0,"코미디,드라마",(주)넥스트엔터테인먼트월드(NEW),남자,남자,남자,0
107,스물,2015-03-25,2015-05-10,46,13,12,2191,5.6,737000,23552030686,122,3042982,0,"코미디,드라마",(주)넥스트엔터테인먼트월드(NEW),남자,남자,남자,0
108,스물,2015-03-25,2015-05-11,47,12,11,1856,3.6,403000,23552433686,67,3043049,0,"코미디,드라마",(주)넥스트엔터테인먼트월드(NEW),남자,남자,남자,0
109,스물,2015-03-25,2015-05-12,48,15,13,2376,9.8,1210000,23553643686,233,3043282,0,"코미디,드라마",(주)넥스트엔터테인먼트월드(NEW),남자,남자,남자,0
110,스물,2015-03-25,2015-05-13,49,12,10,1666,4.0,393000,23554036686,67,3043349,0,"코미디,드라마",(주)넥스트엔터테인먼트월드(NEW),남자,남자,남자,0
111,스물,2015-03-25,2015-05-14,50,6,6,690,7.4,277000,23554313686,51,3043400,0,"코미디,드라마",(주)넥스트엔터테인먼트월드(NEW),남자,남자,남자,0
112,스물,2015-03-25,2015-05-15,51,6,6,690,9.0,342000,23554655686,62,3043462,0,"코미디,드라마",(주)넥스트엔터테인먼트월드(NEW),남자,남자,남자,0
113,스물,2015-03-25,2015-05-16,52,6,6,690,8.8,343000,23554998686,61,3043523,0,"코미디,드라마",(주)넥스트엔터테인먼트월드(NEW),남자,남자,남자,0
114,스물,2015-03-25,2015-05-17,53,6,6,690,7.4,273000,23555271686,51,3043574,0,"코미디,드라마",(주)넥스트엔터테인먼트월드(NEW),남자,남자,남자,0
115,스물,2015-03-25,2015-05-18,54,5,5,666,6.8,231000,23555502686,45,3043619,0,"코미디,드라마",(주)넥스트엔터테인먼트월드(NEW),남자,남자,남자,0
116,스물,2015-03-25,2015-05-19,55,6,6,690,6.8,245000,23555747686,47,3043666,0,"코미디,드라마",(주)넥스트엔터테인먼트월드(NEW),남자,남자,남자,0
117,스물,2015-03-25,2015-05-20,56,3,3,228,8.3,98000,23555845686,19,3043685,0,"코미디,드라마",(주)넥스트엔터테인먼트월드(NEW),남자,남자,남자,0
118,스물,2015-03-25,2015-05-26,62,1,1,232,100.0,1624000,23557469686,232,3043917,0,"코미디,드라마",(주)넥스트엔터테인먼트월드(NEW),남자,남자,남자,0
119,스물,2015-03-25,2015-06-05,72,1,1,217,100.0,1519000,23558988686,217,3044134,0,"코미디,드라마",(주)넥스트엔터테인먼트월드(NEW),남자,남자,남자,0
120,스물,2015-03-25,2015-11-15,235,1,1,85,0.0,0,23558988686,0,3044134,0,"코미디,드라마",(주)넥스트엔터테인먼트월드(NEW),남자,남자,남자,0
121,스물,2015-03-25,2015-11-19,239,1,1,85,0.0,0,23558988686,0,3044134,0,"코미디,드라마",(주)넥스트엔터테인먼트월드(NEW),남자,남자,남자,0
122,스물,2015-03-25,2015-11-26,246,2,2,221,100.0,1450000,23560438686,221,3044355,0,"코미디,드라마",(주)넥스트엔터테인먼트월드(NEW),남자,남자,남자,0
123,스물,2015-03-25,2015-12-01,251,1,1,98,11.2,65000,23560503686,11,3044366,0,"코미디,드라마",(주)넥스트엔터테인먼트월드(NEW),남자,남자,남자,0
124,스물,2015-03-25,2015-12-02,252,1,1,98,3.1,18000,23560521686,3,3044369,0,"코미디,드라마",(주)넥스트엔터테인먼트월드(NEW),남자,남자,남자,0
125,스물,2015-03-25,2015-12-04,254,2,2,221,100.0,1450000,23561971686,221,3044590,0,"코미디,드라마",(주)넥스트엔터테인먼트월드(NEW),남자,남자,남자,0
126,스물,2015-03-25,2015-12-16,266,2,2,221,100.0,1450000,23563421686,221,3044811,0,"코미디,드라마",(주)넥스트엔터테인먼트월드(NEW),남자,남자,남자,0
127,스물,2015-03-25,2016-03-28,369,1,1,44,4.6,12000,23563433686,2,3044813,0,"코미디,드라마",(주)넥스트엔터테인먼트월드(NEW),남자,남자,남자,0
128,스물,2015-03-25,2016-03-30,371,1,1,110,8.2,45000,23563478686,9,3044822,0,"코미디,드라마",(주)넥스트엔터테인먼트월드(NEW),남자,남자,남자,0
129,스물,2015-03-25,2016-03-31,372,2,2,140,7.1,65000,23563543686,10,3044832,0,"코미디,드라마",(주)넥스트엔터테인먼트월드(NEW),남자,남자,남자,0
130,스물,2015-03-25,2016-04-01,373,2,2,206,13.1,162000,23563705686,27,3044859,0,"코미디,드라마",(주)넥스트엔터테인먼트월드(NEW),남자,남자,남자,0
131,귀향,2016-02-24,2016-01-11,-44,1,1,172,72.1,1116000,1116000,124,124,1,드라마,(주)와우픽쳐스,남자,남자,여자,1
132,귀향,2016-02-24,2016-01-13,-42,1,1,282,100.0,2538000,3654000,282,406,1,드라마,(주)와우픽쳐스,남자,남자,여자,1
133,귀향,2016-02-24,2016-02-04,-20,2,2,524,100.0,4192000,7846000,524,930,1,드라마,(주)와우픽쳐스,남자,남자,여자,1
134,귀향,2016-02-24,2016-02-15,-9,21,21,5590,99.4,43330000,51176000,5556,6486,1,드라마,(주)와우픽쳐스,남자,남자,여자,1
135,귀향,2016-02-24,2016-02-16,-8,13,13,2816,98.8,21439000,72615000,2782,9268,1,드라마,(주)와우픽쳐스,남자,남자,여자,1
136,귀향,2016-02-24,2016-02-17,-7,1,1,149,100.0,1043000,73658000,149,9417,1,드라마,(주)와우픽쳐스,남자,남자,여자,1
137,귀향,2016-02-24,2016-02-18,-6,1,1,149,100.0,1043000,74701000,149,9566,1,드라마,(주)와우픽쳐스,남자,남자,여자,1
138,귀향,2016-02-24,2016-02-20,-4,5,4,1167,100.0,7002000,81703000,1167,10733,1,드라마,(주)와우픽쳐스,남자,남자,여자,1
139,귀향,2016-02-24,2016-02-22,-2,2,2,321,100.0,2075000,83778000,321,11054,1,드라마,(주)와우픽쳐스,남자,남자,여자,1
140,귀향,2016-02-24,2016-02-24,0,2138,513,365656,43.3,962008400,1045786400,158174,169228,1,드라마,(주)와우픽쳐스,남자,남자,여자,1
141,귀향,2016-02-24,2016-02-25,1,2224,528,402360,33.5,982667700,2028454100,134742,303970,1,드라마,(주)와우픽쳐스,남자,남자,여자,1
142,귀향,2016-02-24,2016-02-26,2,2467,589,465192,37.3,1339968655,3368422755,173714,477684,1,드라마,(주)와우픽쳐스,남자,남자,여자,1
143,귀향,2016-02-24,2016-02-27,3,3222,770,630310,49.5,2455873351,5824296106,312202,789886,1,드라마,(주)와우픽쳐스,남자,남자,여자,1
144,귀향,2016-02-24,2016-02-28,4,3293,797,647527,49.4,2515327800,8339623906,320062,1109948,1,드라마,(주)와우픽쳐스,남자,남자,여자,1
145,귀향,2016-02-24,2016-02-29,5,3481,783,702414,34.2,1749558698,10089182604,240473,1350421,1,드라마,(주)와우픽쳐스,남자,남자,여자,1
146,귀향,2016-02-24,2016-03-01,6,3938,876,811135,55.1,3466680000,13555862604,446819,1797240,1,드라마,(주)와우픽쳐스,남자,남자,여자,1
147,귀향,2016-02-24,2016-03-02,7,3573,763,743480,14.9,801281600,14357144204,110506,1907746,1,드라마,(주)와우픽쳐스,남자,남자,여자,1
148,귀향,2016-02-24,2016-03-03,8,3444,750,701968,13.7,702926000,15060070204,96453,2004199,1,드라마,(주)와우픽쳐스,남자,남자,여자,1
149,귀향,2016-02-24,2016-03-04,9,3612,771,738658,15.9,930341000,15990411204,117486,2121685,1,드라마,(주)와우픽쳐스,남자,남자,여자,1
150,귀향,2016-02-24,2016-03-05,10,4088,861,841306,29.9,2041924732,18032335936,251892,2373577,1,드라마,(주)와우픽쳐스,남자,남자,여자,1
151,귀향,2016-02-24,2016-03-06,11,3916,846,808091,28.7,1868625900,19900961836,232051,2605628,1,드라마,(주)와우픽쳐스,남자,남자,여자,1
152,귀향,2016-02-24,2016-03-07,12,3495,757,718768,10.1,527713400,20428675236,72612,2678240,1,드라마,(주)와우픽쳐스,남자,남자,여자,1
153,귀향,2016-02-24,2016-03-08,13,3491,773,716083,9.3,476968000,20905643236,66751,2744991,1,드라마,(주)와우픽쳐스,남자,남자,여자,1
154,귀향,2016-02-24,2016-03-09,14,3415,760,700994,8.6,428271800,21333915036,60012,2805003,1,드라마,(주)와우픽쳐스,남자,남자,여자,1
155,귀향,2016-02-24,2016-03-10,15,2445,585,474152,10.7,358766800,21692681836,50895,2855898,1,드라마,(주)와우픽쳐스,남자,남자,여자,1
156,귀향,2016-02-24,2016-03-11,16,2540,592,495507,11.0,422519161,22115200997,54611,2910509,1,드라마,(주)와우픽쳐스,남자,남자,여자,1
157,귀향,2016-02-24,2016-03-12,17,2743,669,547401,22.0,956237145,23071438142,120424,3030933,1,드라마,(주)와우픽쳐스,남자,남자,여자,1
158,귀향,2016-02-24,2016-03-13,18,2616,654,520641,21.5,889251900,23960690042,111687,3142620,1,드라마,(주)와우픽쳐스,남자,남자,여자,1
159,귀향,2016-02-24,2016-03-14,19,2417,577,471805,7.5,251622100,24212312142,35153,3177773,1,드라마,(주)와우픽쳐스,남자,남자,여자,1
160,귀향,2016-02-24,2016-03-15,20,2390,603,465763,7.5,238854500,24451166642,34762,3212535,1,드라마,(주)와우픽쳐스,남자,남자,여자,1
161,귀향,2016-02-24,2016-03-16,21,2371,596,458701,6.8,218852300,24670018942,31099,3243634,1,드라마,(주)와우픽쳐스,남자,남자,여자,1
162,귀향,2016-02-24,2016-03-17,22,2076,546,389033,7.5,197998700,24868017642,29117,3272751,1,드라마,(주)와우픽쳐스,남자,남자,여자,1
163,귀향,2016-02-24,2016-03-18,23,2210,554,407581,8.5,265322428,25133340070,34489,3307240,1,드라마,(주)와우픽쳐스,남자,남자,여자,1
164,귀향,2016-02-24,2016-03-19,24,2427,607,451269,14.3,510155220,25643495290,64606,3371846,1,드라마,(주)와우픽쳐스,남자,남자,여자,1
165,귀향,2016-02-24,2016-03-20,25,2265,570,423131,12.4,419900800,26063396090,52518,3424364,1,드라마,(주)와우픽쳐스,남자,남자,여자,1
166,귀향,2016-02-24,2016-03-21,26,1977,538,365697,4.7,121832800,26185228890,17238,3441602,1,드라마,(주)와우픽쳐스,남자,남자,여자,1
167,귀향,2016-02-24,2016-03-22,27,1965,541,364255,4.7,121012800,26306241690,17040,3458642,1,드라마,(주)와우픽쳐스,남자,남자,여자,1
168,귀향,2016-02-24,2016-03-23,28,1928,553,349863,5.1,126117500,26432359190,17826,3476468,1,드라마,(주)와우픽쳐스,남자,남자,여자,1
169,귀향,2016-02-24,2016-03-24,29,815,400,102727,9.4,68108300,26500467490,9683,3486151,1,드라마,(주)와우픽쳐스,남자,남자,여자,1
170,귀향,2016-02-24,2016-03-25,30,856,406,107296,10.3,82718500,26583185990,11031,3497182,1,드라마,(주)와우픽쳐스,남자,남자,여자,1
171,귀향,2016-02-24,2016-03-26,31,771,401,93922,18.7,139522100,26722708090,17524,3514706,1,드라마,(주)와우픽쳐스,남자,남자,여자,1
172,귀향,2016-02-24,2016-03-27,32,732,392,91730,18.2,133351700,26856059790,16685,3531391,1,드라마,(주)와우픽쳐스,남자,남자,여자,1
173,귀향,2016-02-24,2016-03-28,33,831,405,104964,7.3,54350600,26910410390,7705,3539096,1,드라마,(주)와우픽쳐스,남자,남자,여자,1
174,귀향,2016-02-24,2016-03-29,34,835,416,105315,8.5,61923900,26972334290,8930,3548026,1,드라마,(주)와우픽쳐스,남자,남자,여자,1
175,귀향,2016-02-24,2016-03-30,35,368,238,47424,11.4,32791200,27005125490,5412,3553438,1,드라마,(주)와우픽쳐스,남자,남자,여자,1
176,귀향,2016-02-24,2016-03-31,36,344,213,44703,8.8,27378600,27032504090,3942,3557380,1,드라마,(주)와우픽쳐스,남자,남자,여자,1
177,귀향,2016-02-24,2016-04-01,37,340,205,43526,9.6,29975500,27062479590,4182,3561562,1,드라마,(주)와우픽쳐스,남자,남자,여자,1
178,귀향,2016-02-24,2016-04-02,38,321,192,38383,12.7,38644500,27101124090,4872,3566434,1,드라마,(주)와우픽쳐스,남자,남자,여자,1
179,귀향,2016-02-24,2016-04-03,39,310,191,37699,14.4,44008800,27145132890,5419,3571853,1,드라마,(주)와우픽쳐스,남자,남자,여자,1
180,귀향,2016-02-24,2016-04-04,40,333,198,42758,5.3,16299500,27161432390,2285,3574138,1,드라마,(주)와우픽쳐스,남자,남자,여자,1
181,귀향,2016-02-24,2016-04-05,41,297,179,38901,5.1,14343400,27175775790,1991,3576129,1,드라마,(주)와우픽쳐스,남자,남자,여자,1
182,귀향,2016-02-24,2016-04-06,42,297,196,39141,4.6,12600700,27188376490,1800,3577929,1,드라마,(주)와우픽쳐스,남자,남자,여자,1
183,귀향,2016-02-24,2016-04-07,43,83,63,10076,8.3,5154900,27193531390,833,3578762,1,드라마,(주)와우픽쳐스,남자,남자,여자,1
184,귀향,2016-02-24,2016-04-08,44,83,63,9921,5.8,4290000,27197821390,577,3579339,1,드라마,(주)와우픽쳐스,남자,남자,여자,1
185,귀향,2016-02-24,2016-04-09,45,87,65,10637,11.6,9116000,27206937390,1235,3580574,1,드라마,(주)와우픽쳐스,남자,남자,여자,1
186,귀향,2016-02-24,2016-04-10,46,83,62,10132,8.7,6965200,27213902590,886,3581460,1,드라마,(주)와우픽쳐스,남자,남자,여자,1
187,귀향,2016-02-24,2016-04-11,47,71,49,8625,3.6,2272500,27216175090,311,3581771,1,드라마,(주)와우픽쳐스,남자,남자,여자,1
188,귀향,2016-02-24,2016-04-12,48,84,63,10474,6.6,4360900,27220535990,689,3582460,1,드라마,(주)와우픽쳐스,남자,남자,여자,1
189,귀향,2016-02-24,2016-04-13,49,7,5,705,10.5,495000,27221030990,74,3582534,1,드라마,(주)와우픽쳐스,남자,남자,여자,1
190,귀향,2016-02-24,2016-04-14,50,10,9,1375,52.0,4992000,27226022990,715,3583249,1,드라마,(주)와우픽쳐스,남자,남자,여자,1
191,귀향,2016-02-24,2016-04-15,51,8,6,774,10.6,429000,27226451990,82,3583331,1,드라마,(주)와우픽쳐스,남자,남자,여자,1
192,귀향,2016-02-24,2016-04-16,52,7,6,727,17.2,702000,27227153990,125,3583456,1,드라마,(주)와우픽쳐스,남자,남자,여자,1
193,귀향,2016-02-24,2016-04-17,53,8,6,956,6.4,447500,27227601490,61,3583517,1,드라마,(주)와우픽쳐스,남자,남자,여자,1
194,귀향,2016-02-24,2016-04-18,54,8,8,960,17.8,1179000,27228780490,171,3583688,1,드라마,(주)와우픽쳐스,남자,남자,여자,1
195,귀향,2016-02-24,2016-04-19,55,12,11,1642,39.6,2947000,27231727490,650,3584338,1,드라마,(주)와우픽쳐스,남자,남자,여자,1
196,귀향,2016-02-24,2016-04-20,56,8,7,1076,19.9,1695500,27233422990,214,3584552,1,드라마,(주)와우픽쳐스,남자,남자,여자,1
197,귀향,2016-02-24,2016-04-21,57,3,3,362,42.8,1105000,27234527990,155,3584707,1,드라마,(주)와우픽쳐스,남자,남자,여자,1
198,귀향,2016-02-24,2016-04-22,58,6,6,840,33.7,1723000,27236250990,283,3584990,1,드라마,(주)와우픽쳐스,남자,남자,여자,1
199,귀향,2016-02-24,2016-04-23,59,4,4,474,32.1,1054000,27237304990,152,3585142,1,드라마,(주)와우픽쳐스,남자,남자,여자,1
200,귀향,2016-02-24,2016-04-24,60,5,5,702,6.0,322000,27237626990,42,3585184,1,드라마,(주)와우픽쳐스,남자,남자,여자,1
201,귀향,2016-02-24,2016-04-25,61,2,2,226,2.7,38000,27237664990,6,3585190,1,드라마,(주)와우픽쳐스,남자,남자,여자,1
202,귀향,2016-02-24,2016-04-26,62,3,3,436,5.1,169000,27237833990,22,3585212,1,드라마,(주)와우픽쳐스,남자,남자,여자,1
203,귀향,2016-02-24,2016-04-27,63,1,1,147,100.0,1029000,27238862990,147,3585359,1,드라마,(주)와우픽쳐스,남자,남자,여자,1
204,귀향,2016-02-24,2016-04-29,65,1,1,110,100.0,770000,27239632990,110,3585469,1,드라마,(주)와우픽쳐스,남자,남자,여자,1
205,귀향,2016-02-24,2016-04-30,66,1,1,126,6.4,51000,27239683990,8,3585477,1,드라마,(주)와우픽쳐스,남자,남자,여자,1
206,귀향,2016-02-24,2016-05-01,67,1,1,200,0.5,6000,27239689990,1,3585478,1,드라마,(주)와우픽쳐스,남자,남자,여자,1
207,귀향,2016-02-24,2016-05-02,68,1,1,110,2.7,21000,27239710990,3,3585481,1,드라마,(주)와우픽쳐스,남자,남자,여자,1
208,귀향,2016-02-24,2016-05-07,73,1,1,126,12.7,90000,27239800990,16,3585497,1,드라마,(주)와우픽쳐스,남자,남자,여자,1
209,귀향,2016-02-24,2016-05-11,77,1,1,128,78.1,600000,27240400990,100,3585597,1,드라마,(주)와우픽쳐스,남자,남자,여자,1
210,귀향,2016-02-24,2016-05-13,79,3,3,463,86.4,2492000,27242892990,400,3585997,1,드라마,(주)와우픽쳐스,남자,남자,여자,1
211,귀향,2016-02-24,2016-05-14,80,1,1,126,7.1,45000,27242937990,9,3586006,1,드라마,(주)와우픽쳐스,남자,남자,여자,1
212,귀향,2016-02-24,2016-05-17,83,1,1,125,0.0,0,27242937990,0,3586006,1,드라마,(주)와우픽쳐스,남자,남자,여자,1
213,귀향,2016-02-24,2016-05-20,86,1,1,123,100.0,861000,27243798990,123,3586129,1,드라마,(주)와우픽쳐스,남자,남자,여자,1
214,귀향,2016-02-24,2016-05-21,87,2,2,256,58.6,998000,27244796990,150,3586279,1,드라마,(주)와우픽쳐스,남자,남자,여자,1
215,귀향,2016-02-24,2016-05-28,94,1,1,126,4.0,25000,27244821990,5,3586284,1,드라마,(주)와우픽쳐스,남자,남자,여자,1
216,귀향,2016-02-24,2016-06-02,99,1,1,189,79.4,600000,27245421990,150,3586434,1,드라마,(주)와우픽쳐스,남자,남자,여자,1
217,귀향,2016-02-24,2016-06-04,101,1,1,126,6.4,40000,27245461990,8,3586442,1,드라마,(주)와우픽쳐스,남자,남자,여자,1
218,귀향,2016-02-24,2016-06-08,105,1,1,102,98.0,800000,27246261990,100,3586542,1,드라마,(주)와우픽쳐스,남자,남자,여자,1
219,귀향,2016-02-24,2016-06-09,106,1,1,151,72.9,900000,27247161990,110,3586652,1,드라마,(주)와우픽쳐스,남자,남자,여자,1
220,귀향,2016-02-24,2016-06-11,108,1,1,126,6.4,40000,27247201990,8,3586660,1,드라마,(주)와우픽쳐스,남자,남자,여자,1
221,귀향,2016-02-24,2016-06-13,110,1,1,151,33.1,250000,27247451990,50,3586710,1,드라마,(주)와우픽쳐스,남자,남자,여자,1
222,귀향,2016-02-24,2016-06-18,115,1,1,126,6.4,40000,27247491990,8,3586718,1,드라마,(주)와우픽쳐스,남자,남자,여자,1
223,귀향,2016-02-24,2016-06-25,122,1,1,126,27.0,170000,27247661990,34,3586752,1,드라마,(주)와우픽쳐스,남자,남자,여자,1
224,귀향,2016-02-24,2016-06-28,125,1,1,99,0.0,0,27247661990,0,3586752,1,드라마,(주)와우픽쳐스,남자,남자,여자,1
225,귀향,2016-02-24,2016-06-29,126,1,1,99,0.0,0,27247661990,0,3586752,1,드라마,(주)와우픽쳐스,남자,남자,여자,1
226,귀향,2016-02-24,2016-06-30,127,1,1,99,0.0,0,27247661990,0,3586752,1,드라마,(주)와우픽쳐스,남자,남자,여자,1
227,귀향,2016-02-24,2016-07-07,134,1,1,157,100.0,942000,27248603990,157,3586909,1,드라마,(주)와우픽쳐스,남자,남자,여자,1
228,귀향,2016-02-24,2016-07-16,143,1,1,126,9.5,60000,27248663990,12,3586921,1,드라마,(주)와우픽쳐스,남자,남자,여자,1
229,귀향,2016-02-24,2016-07-23,150,1,1,126,6.4,42000,27248705990,8,3586929,1,드라마,(주)와우픽쳐스,남자,남자,여자,1
230,귀향,2016-02-24,2016-11-07,257,1,1,148,100.0,740000,27249445990,148,3587077,1,드라마,(주)와우픽쳐스,남자,남자,여자,1
231,귀향,2016-02-24,2016-11-27,277,2,1,372,4.0,44000,27249489990,15,3587092,1,드라마,(주)와우픽쳐스,남자,남자,여자,1
232,귀향,2016-02-24,2016-11-28,278,2,1,372,7.3,88000,27249577990,27,3587119,1,드라마,(주)와우픽쳐스,남자,남자,여자,1
233,귀향,2016-02-24,2016-11-29,279,2,1,372,9.4,105000,27249682990,35,3587154,1,드라마,(주)와우픽쳐스,남자,남자,여자,1
234,귀향,2016-02-24,2016-12-04,284,1,1,186,0.5,2000,27249684990,1,3587155,1,드라마,(주)와우픽쳐스,남자,남자,여자,1
235,귀향,2016-02-24,2016-12-05,285,1,1,186,7.0,39000,27249723990,13,3587168,1,드라마,(주)와우픽쳐스,남자,남자,여자,1
236,귀향,2016-02-24,2016-12-06,286,1,1,186,2.7,15000,27249738990,5,3587173,1,드라마,(주)와우픽쳐스,남자,남자,여자,1
237,귀향,2016-02-24,2017-03-01,371,1,1,40,15.0,48000,27249786990,6,3587179,1,드라마,(주)와우픽쳐스,남자,남자,여자,1
238,귀향,2016-02-24,2017-03-18,388,1,1,36,8.3,15000,27249801990,3,3587182,1,드라마,(주)와우픽쳐스,남자,남자,여자,1
239,귀향,2016-02-24,2018-04-18,784,3,1,504,5.2,52000,1222000,26,220,1,드라마,(주)와우픽쳐스,남자,남자,여자,1
240,귀향,2016-02-24,2018-04-19,785,3,1,504,7.3,74000,1296000,37,257,1,드라마,(주)와우픽쳐스,남자,남자,여자,1
241,귀향,2016-02-24,2018-04-20,786,3,1,504,5.6,56000,1352000,28,285,1,드라마,(주)와우픽쳐스,남자,남자,여자,1
242,시간이탈자,2016-04-13,2016-03-28,-16,1,1,326,100.0,1956000,1956000,326,326,1,스릴러,씨제이이앤엠(주),남자,남자,여자,1
243,시간이탈자,2016-04-13,2016-04-05,-8,6,5,1563,89.6,10362000,12318000,1401,1727,1,스릴러,씨제이이앤엠(주),남자,남자,여자,1
244,시간이탈자,2016-04-13,2016-04-06,-7,1,1,326,50.0,1141000,13459000,163,1890,1,스릴러,씨제이이앤엠(주),남자,남자,여자,1
245,시간이탈자,2016-04-13,2016-04-08,-5,1,1,326,100.0,2934000,16393000,326,2216,1,스릴러,씨제이이앤엠(주),남자,남자,여자,1
246,시간이탈자,2016-04-13,2016-04-09,-4,1,1,841,0.0,0,16393000,0,2216,1,스릴러,씨제이이앤엠(주),남자,남자,여자,1
247,시간이탈자,2016-04-13,2016-04-11,-2,23,23,5667,48.6,24369500,40762500,2753,4969,1,스릴러,씨제이이앤엠(주),남자,남자,여자,1
248,시간이탈자,2016-04-13,2016-04-12,-1,37,37,7508,97.2,55902000,96664500,7296,12265,1,스릴러,씨제이이앤엠(주),남자,남자,여자,1
249,시간이탈자,2016-04-13,2016-04-13,0,3304,673,655275,23.8,1295199400,1391863900,155917,168182,1,스릴러,씨제이이앤엠(주),남자,남자,여자,1
250,시간이탈자,2016-04-13,2016-04-14,1,3178,646,633034,6.7,321289700,1713153600,42433,210615,1,스릴러,씨제이이앤엠(주),남자,남자,여자,1
251,시간이탈자,2016-04-13,2016-04-15,2,3362,681,669747,9.5,520667375,2233820975,63886,274501,1,스릴러,씨제이이앤엠(주),남자,남자,여자,1
252,시간이탈자,2016-04-13,2016-04-16,3,3631,733,732670,19.9,1235989060,3469810035,145976,420477,1,스릴러,씨제이이앤엠(주),남자,남자,여자,1
253,시간이탈자,2016-04-13,2016-04-17,4,3546,718,716300,17.6,1064075400,4533885435,126343,546820,1,스릴러,씨제이이앤엠(주),남자,남자,여자,1
254,시간이탈자,2016-04-13,2016-04-18,5,3229,652,651778,5.9,295925800,4829811235,38651,585471,1,스릴러,씨제이이앤엠(주),남자,남자,여자,1
255,시간이탈자,2016-04-13,2016-04-19,6,3259,688,649759,6.1,300711300,5130522535,39783,625254,1,스릴러,씨제이이앤엠(주),남자,남자,여자,1
256,시간이탈자,2016-04-13,2016-04-20,7,2905,627,592471,6.5,289813500,5420336035,38723,663977,1,스릴러,씨제이이앤엠(주),남자,남자,여자,1
257,시간이탈자,2016-04-13,2016-04-21,8,2718,577,546263,7.5,304661800,5724997835,41070,705047,1,스릴러,씨제이이앤엠(주),남자,남자,여자,1
258,시간이탈자,2016-04-13,2016-04-22,9,2850,603,573069,9.2,432108661,6157106496,52957,758004,1,스릴러,씨제이이앤엠(주),남자,남자,여자,1
259,시간이탈자,2016-04-13,2016-04-23,10,3222,663,661522,15.3,846583364,7003689860,100883,858887,1,스릴러,씨제이이앤엠(주),남자,남자,여자,1
260,시간이탈자,2016-04-13,2016-04-24,11,3145,651,642916,13.3,721944900,7725634760,85570,944457,1,스릴러,씨제이이앤엠(주),남자,남자,여자,1
261,시간이탈자,2016-04-13,2016-04-25,12,2763,575,562263,5.0,216444100,7942078860,28297,972754,1,스릴러,씨제이이앤엠(주),남자,남자,여자,1
262,시간이탈자,2016-04-13,2016-04-26,13,2784,591,562391,5.3,225850900,8167929760,29701,1002455,1,스릴러,씨제이이앤엠(주),남자,남자,여자,1
263,시간이탈자,2016-04-13,2016-04-27,14,1230,460,161050,15.1,146578900,8314508660,24305,1026760,1,스릴러,씨제이이앤엠(주),남자,남자,여자,1
264,시간이탈자,2016-04-13,2016-04-28,15,1268,432,165946,10.1,126736800,8441245460,16806,1043566,1,스릴러,씨제이이앤엠(주),남자,남자,여자,1
265,시간이탈자,2016-04-13,2016-04-29,16,1257,447,163979,14.6,195484672,8636730132,23937,1067503,1,스릴러,씨제이이앤엠(주),남자,남자,여자,1
266,시간이탈자,2016-04-13,2016-04-30,17,1056,426,130044,26.0,281479363,8918209495,33763,1101266,1,스릴러,씨제이이앤엠(주),남자,남자,여자,1
267,시간이탈자,2016-04-13,2016-05-01,18,1005,428,125202,23.1,244382600,9162592095,28961,1130227,1,스릴러,씨제이이앤엠(주),남자,남자,여자,1
268,시간이탈자,2016-04-13,2016-05-02,19,1183,438,153868,7.9,92277700,9254869795,12181,1142408,1,스릴러,씨제이이앤엠(주),남자,남자,여자,1
269,시간이탈자,2016-04-13,2016-05-03,20,1210,432,155263,10.2,118539600,9373409395,15802,1158210,1,스릴러,씨제이이앤엠(주),남자,남자,여자,1
270,시간이탈자,2016-04-13,2016-05-04,21,483,233,61373,12.7,59247800,9432657195,7821,1166031,1,스릴러,씨제이이앤엠(주),남자,남자,여자,1
271,시간이탈자,2016-04-13,2016-05-05,22,257,157,32796,23.2,63923800,9496580995,7614,1173645,1,스릴러,씨제이이앤엠(주),남자,남자,여자,1
272,시간이탈자,2016-04-13,2016-05-06,23,281,161,36069,22.4,68546400,9565127395,8075,1181720,1,스릴러,씨제이이앤엠(주),남자,남자,여자,1
273,시간이탈자,2016-04-13,2016-05-07,24,270,154,34686,16.2,47767600,9612894995,5618,1187338,1,스릴러,씨제이이앤엠(주),남자,남자,여자,1
274,시간이탈자,2016-04-13,2016-05-08,25,254,145,32257,13.2,36711700,9649606695,4249,1191587,1,스릴러,씨제이이앤엠(주),남자,남자,여자,1
275,시간이탈자,2016-04-13,2016-05-09,26,467,235,62183,5.5,26534400,9676141095,3416,1195003,1,스릴러,씨제이이앤엠(주),남자,남자,여자,1
276,시간이탈자,2016-04-13,2016-05-10,27,489,231,64297,7.1,35166500,9711307595,4593,1199596,1,스릴러,씨제이이앤엠(주),남자,남자,여자,1
277,시간이탈자,2016-04-13,2016-05-11,28,276,179,39081,5.0,13715600,9725023195,1951,1201547,1,스릴러,씨제이이앤엠(주),남자,남자,여자,1
278,시간이탈자,2016-04-13,2016-05-12,29,24,17,3331,3.8,955000,9725978195,125,1201672,1,스릴러,씨제이이앤엠(주),남자,남자,여자,1
279,시간이탈자,2016-04-13,2016-05-13,30,29,21,3860,4.7,1593000,9727571195,183,1201855,1,스릴러,씨제이이앤엠(주),남자,남자,여자,1
280,시간이탈자,2016-04-13,2016-05-14,31,11,10,1771,6.0,906500,9728477695,106,1201961,1,스릴러,씨제이이앤엠(주),남자,남자,여자,1
281,시간이탈자,2016-04-13,2016-05-15,32,9,9,1439,6.2,792000,9729269695,89,1202050,1,스릴러,씨제이이앤엠(주),남자,남자,여자,1
282,시간이탈자,2016-04-13,2016-05-16,33,15,14,2271,4.2,714000,9729983695,96,1202146,1,스릴러,씨제이이앤엠(주),남자,남자,여자,1
283,시간이탈자,2016-04-13,2016-05-17,34,13,10,1763,3.3,424500,9730408195,58,1202204,1,스릴러,씨제이이앤엠(주),남자,남자,여자,1
284,시간이탈자,2016-04-13,2016-05-18,35,20,13,2804,4.1,854000,9731262195,116,1202320,1,스릴러,씨제이이앤엠(주),남자,남자,여자,1
285,시간이탈자,2016-04-13,2016-05-25,42,1,1,172,0.0,0,9731262195,0,1202320,1,스릴러,씨제이이앤엠(주),남자,남자,여자,1
286,시간이탈자,2016-04-13,2016-06-18,66,1,1,205,31.2,576000,9731838195,64,1202384,1,스릴러,씨제이이앤엠(주),남자,남자,여자,1
287,시간이탈자,2016-04-13,2019-10-12,1277,1,1,127,100.0,762000,9732600195,127,1202511,1,스릴러,씨제이이앤엠(주),남자,남자,여자,1
288,아가씨,2016-06-01,2016-05-25,-7,7,6,1712,90.5,10629000,10629000,1549,1549,2,"스릴러,드라마",씨제이이앤엠(주),남자,여자,여자,2
289,아가씨,2016-06-01,2016-05-27,-5,14,12,3165,100.0,30445000,41074000,3165,4714,2,"스릴러,드라마",씨제이이앤엠(주),남자,여자,여자,2
290,아가씨,2016-06-01,2016-05-30,-2,4,4,878,100.0,7902000,48976000,878,5592,2,"스릴러,드라마",씨제이이앤엠(주),남자,여자,여자,2
291,아가씨,2016-06-01,2016-05-31,-1,30,30,6390,81.0,47921200,96897200,5176,10768,2,"스릴러,드라마",씨제이이앤엠(주),남자,여자,여자,2
292,아가씨,2016-06-01,2016-06-01,0,4701,1016,912336,31.8,2200581820,2297479020,290024,300792,2,"스릴러,드라마",씨제이이앤엠(주),남자,여자,여자,2
293,아가씨,2016-06-01,2016-06-02,1,4824,1069,928195,28.0,1969080600,4266559620,259971,560763,2,"스릴러,드라마",씨제이이앤엠(주),남자,여자,여자,2
294,아가씨,2016-06-01,2016-06-03,2,5104,1122,985601,31.7,2650815763,6917375383,312873,873636,2,"스릴러,드라마",씨제이이앤엠(주),남자,여자,여자,2
295,아가씨,2016-06-01,2016-06-04,3,5457,1171,1050931,45.8,4147100927,11064476310,481442,1355078,2,"스릴러,드라마",씨제이이앤엠(주),남자,여자,여자,2
296,아가씨,2016-06-01,2016-06-05,4,5398,1164,1047859,44.9,4082687400,15147163710,470236,1825314,2,"스릴러,드라마",씨제이이앤엠(주),남자,여자,여자,2
297,아가씨,2016-06-01,2016-06-06,5,5141,1137,1009727,39.1,3397423800,18544587510,395072,2220386,2,"스릴러,드라마",씨제이이앤엠(주),남자,여자,여자,2
298,아가씨,2016-06-01,2016-06-07,6,4874,1074,954716,15.4,1109379400,19653966910,146895,2367281,2,"스릴러,드라마",씨제이이앤엠(주),남자,여자,여자,2
299,아가씨,2016-06-01,2016-06-08,7,4833,1074,947006,14.4,1033983900,20687950810,136550,2503831,2,"스릴러,드라마",씨제이이앤엠(주),남자,여자,여자,2
300,아가씨,2016-06-01,2016-06-09,8,2721,723,451884,23.7,806209300,21494160110,106905,2610736,2,"스릴러,드라마",씨제이이앤엠(주),남자,여자,여자,2
301,아가씨,2016-06-01,2016-06-10,9,2856,753,474632,28.0,1126346723,22620506833,132708,2743444,2,"스릴러,드라마",씨제이이앤엠(주),남자,여자,여자,2
302,아가씨,2016-06-01,2016-06-11,10,3012,782,514198,41.9,1865480919,24485987752,215487,2958931,2,"스릴러,드라마",씨제이이앤엠(주),남자,여자,여자,2
303,아가씨,2016-06-01,2016-06-12,11,2874,782,488129,36.6,1549113600,26035101352,178490,3137421,2,"스릴러,드라마",씨제이이앤엠(주),남자,여자,여자,2
304,아가씨,2016-06-01,2016-06-13,12,2825,728,468389,16.4,576896900,26611998252,76700,3214121,2,"스릴러,드라마",씨제이이앤엠(주),남자,여자,여자,2
305,아가씨,2016-06-01,2016-06-14,13,2845,753,471445,15.9,556061160,27168059412,74710,3288831,2,"스릴러,드라마",씨제이이앤엠(주),남자,여자,여자,2
306,아가씨,2016-06-01,2016-06-15,14,2819,744,471389,15.6,552848000,27720907412,73423,3362254,2,"스릴러,드라마",씨제이이앤엠(주),남자,여자,여자,2
307,아가씨,2016-06-01,2016-06-16,15,2021,567,325392,19.8,481291300,28202198712,64483,3426737,2,"스릴러,드라마",씨제이이앤엠(주),남자,여자,여자,2
308,아가씨,2016-06-01,2016-06-17,16,2090,584,335503,22.6,643879100,28846077812,75919,3502656,2,"스릴러,드라마",씨제이이앤엠(주),남자,여자,여자,2
309,아가씨,2016-06-01,2016-06-18,17,2140,626,339025,34.6,1008243300,29854321112,117150,3619806,2,"스릴러,드라마",씨제이이앤엠(주),남자,여자,여자,2
310,아가씨,2016-06-01,2016-06-19,18,2039,576,327026,28.0,794340500,30648661612,91613,3711419,2,"스릴러,드라마",씨제이이앤엠(주),남자,여자,여자,2
311,아가씨,2016-06-01,2016-06-20,19,2153,600,352810,14.9,396529400,31045191012,52480,3763899,2,"스릴러,드라마",씨제이이앤엠(주),남자,여자,여자,2
312,아가씨,2016-06-01,2016-06-21,20,2151,608,352921,15.5,411013700,31456204712,54708,3818607,2,"스릴러,드라마",씨제이이앤엠(주),남자,여자,여자,2
313,아가씨,2016-06-01,2016-06-22,21,1565,466,225882,20.1,343280600,31799485312,45325,3863932,2,"스릴러,드라마",씨제이이앤엠(주),남자,여자,여자,2
314,아가씨,2016-06-01,2016-06-23,22,1283,442,181963,20.4,279822900,32079308212,37092,3901024,2,"스릴러,드라마",씨제이이앤엠(주),남자,여자,여자,2
315,아가씨,2016-06-01,2016-06-24,23,1326,463,188368,23.7,379706768,32459014980,44597,3945621,2,"스릴러,드라마",씨제이이앤엠(주),남자,여자,여자,2
316,아가씨,2016-06-01,2016-06-25,24,1304,486,177887,33.8,520323351,32979338331,60149,4005770,2,"스릴러,드라마",씨제이이앤엠(주),남자,여자,여자,2
317,아가씨,2016-06-01,2016-06-26,25,1241,468,170371,29.6,437445900,33416784231,50455,4056225,2,"스릴러,드라마",씨제이이앤엠(주),남자,여자,여자,2
318,아가씨,2016-06-01,2016-06-27,26,1378,451,193787,14.7,214260960,33631045191,28523,4084748,2,"스릴러,드라마",씨제이이앤엠(주),남자,여자,여자,2
319,아가씨,2016-06-01,2016-06-28,27,1391,452,197326,14.5,212272100,33843317291,28524,4113272,2,"스릴러,드라마",씨제이이앤엠(주),남자,여자,여자,2
320,아가씨,2016-06-01,2016-06-29,28,795,373,104750,22.0,141903900,33985221191,23087,4136359,2,"스릴러,드라마",씨제이이앤엠(주),남자,여자,여자,2
321,아가씨,2016-06-01,2016-06-30,29,772,345,101508,17.1,127817700,34113038891,17321,4153680,2,"스릴러,드라마",씨제이이앤엠(주),남자,여자,여자,2
322,아가씨,2016-06-01,2016-07-01,30,790,362,104507,16.3,144513000,34257551891,16986,4170666,2,"스릴러,드라마",씨제이이앤엠(주),남자,여자,여자,2
323,아가씨,2016-06-01,2016-07-02,31,714,350,91190,27.4,215600100,34473151991,24964,4195630,2,"스릴러,드라마",씨제이이앤엠(주),남자,여자,여자,2
324,아가씨,2016-06-01,2016-07-03,32,687,353,89104,22.0,169231900,34642383891,19633,4215263,2,"스릴러,드라마",씨제이이앤엠(주),남자,여자,여자,2
325,아가씨,2016-06-01,2016-07-04,33,794,341,104950,11.1,88858700,34731242591,11696,4226959,2,"스릴러,드라마",씨제이이앤엠(주),남자,여자,여자,2
326,아가씨,2016-06-01,2016-07-05,34,800,362,106609,11.6,92652500,34823895091,12353,4239312,2,"스릴러,드라마",씨제이이앤엠(주),남자,여자,여자,2
327,아가씨,2016-06-01,2016-07-06,35,346,191,44034,12.9,43470400,34867365491,5693,4245005,2,"스릴러,드라마",씨제이이앤엠(주),남자,여자,여자,2
328,아가씨,2016-06-01,2016-07-07,36,270,152,33351,15.0,38024300,34905389791,5005,4250010,2,"스릴러,드라마",씨제이이앤엠(주),남자,여자,여자,2
329,아가씨,2016-06-01,2016-07-08,37,268,154,32968,16.3,46620800,34952010591,5363,4255373,2,"스릴러,드라마",씨제이이앤엠(주),남자,여자,여자,2
330,아가씨,2016-06-01,2016-07-09,38,182,119,22557,23.0,46452200,34998462791,5188,4260561,2,"스릴러,드라마",씨제이이앤엠(주),남자,여자,여자,2
331,아가씨,2016-06-01,2016-07-10,39,177,117,21632,20.7,39993100,35038455891,4483,4265044,2,"스릴러,드라마",씨제이이앤엠(주),남자,여자,여자,2
332,아가씨,2016-06-01,2016-07-11,40,301,167,37185,11.2,31520700,35069976591,4160,4269204,2,"스릴러,드라마",씨제이이앤엠(주),남자,여자,여자,2
333,아가씨,2016-06-01,2016-07-12,41,246,149,31197,12.1,27994400,35097970991,3772,4272976,2,"스릴러,드라마",씨제이이앤엠(주),남자,여자,여자,2
334,아가씨,2016-06-01,2016-07-13,42,94,58,11030,13.2,10870500,35108841491,1450,4274426,2,"스릴러,드라마",씨제이이앤엠(주),남자,여자,여자,2
335,아가씨,2016-06-01,2016-07-14,43,74,46,8072,13.5,8146600,35116988091,1089,4275515,2,"스릴러,드라마",씨제이이앤엠(주),남자,여자,여자,2
336,아가씨,2016-06-01,2016-07-15,44,62,40,6940,16.6,9495400,35126483491,1152,4276667,2,"스릴러,드라마",씨제이이앤엠(주),남자,여자,여자,2
337,아가씨,2016-06-01,2016-07-16,45,44,28,4575,24.4,9850000,35136333491,1114,4277781,2,"스릴러,드라마",씨제이이앤엠(주),남자,여자,여자,2
338,아가씨,2016-06-01,2016-07-17,46,40,26,4211,19.9,7511000,35143844491,836,4278617,2,"스릴러,드라마",씨제이이앤엠(주),남자,여자,여자,2
339,아가씨,2016-06-01,2016-07-18,47,87,55,10715,10.9,8545000,35152389491,1164,4279781,2,"스릴러,드라마",씨제이이앤엠(주),남자,여자,여자,2
340,아가씨,2016-06-01,2016-07-19,48,87,54,10395,10.1,7801100,35160190591,1047,4280828,2,"스릴러,드라마",씨제이이앤엠(주),남자,여자,여자,2
341,아가씨,2016-06-01,2016-07-20,49,22,12,1913,13.1,1853100,35162043691,251,4281079,2,"스릴러,드라마",씨제이이앤엠(주),남자,여자,여자,2
342,아가씨,2016-06-01,2016-07-21,50,19,11,1747,20.0,2620100,35164663791,350,4281429,2,"스릴러,드라마",씨제이이앤엠(주),남자,여자,여자,2
343,아가씨,2016-06-01,2016-07-22,51,18,10,1560,18.7,2433000,35167096791,292,4281721,2,"스릴러,드라마",씨제이이앤엠(주),남자,여자,여자,2
344,아가씨,2016-06-01,2016-07-23,52,11,7,1063,29.6,2811500,35169908291,315,4282036,2,"스릴러,드라마",씨제이이앤엠(주),남자,여자,여자,2
345,아가씨,2016-06-01,2016-07-24,53,15,10,1312,30.4,3474000,35173382291,399,4282435,2,"스릴러,드라마",씨제이이앤엠(주),남자,여자,여자,2
346,아가씨,2016-06-01,2016-07-25,54,18,10,1667,18.9,2373000,35175755291,315,4282750,2,"스릴러,드라마",씨제이이앤엠(주),남자,여자,여자,2
347,아가씨,2016-06-01,2016-07-26,55,15,8,1303,22.3,2197300,35177952591,290,4283040,2,"스릴러,드라마",씨제이이앤엠(주),남자,여자,여자,2
348,아가씨,2016-06-01,2016-07-27,56,23,21,2643,21.5,3652500,35181605091,568,4283608,2,"스릴러,드라마",씨제이이앤엠(주),남자,여자,여자,2
349,아가씨,2016-06-01,2016-07-28,57,11,9,1467,16.4,1517200,35183122291,241,4283849,2,"스릴러,드라마",씨제이이앤엠(주),남자,여자,여자,2
350,아가씨,2016-06-01,2016-07-29,58,9,7,1291,17.5,1534000,35184656291,226,4284075,2,"스릴러,드라마",씨제이이앤엠(주),남자,여자,여자,2
351,아가씨,2016-06-01,2016-07-30,59,9,7,1276,22.5,2153000,35186809291,287,4284362,2,"스릴러,드라마",씨제이이앤엠(주),남자,여자,여자,2
352,아가씨,2016-06-01,2016-07-31,60,11,9,1455,21.9,2287000,35189096291,318,4284680,2,"스릴러,드라마",씨제이이앤엠(주),남자,여자,여자,2
353,아가씨,2016-06-01,2016-08-01,61,10,7,1337,25.7,2357000,35191453291,344,4285024,2,"스릴러,드라마",씨제이이앤엠(주),남자,여자,여자,2
354,아가씨,2016-06-01,2016-08-02,62,8,6,1049,22.8,1565200,35193018491,239,4285263,2,"스릴러,드라마",씨제이이앤엠(주),남자,여자,여자,2
355,아가씨,2016-06-01,2016-08-03,63,9,7,1160,20.3,1576000,35194594491,235,4285498,2,"스릴러,드라마",씨제이이앤엠(주),남자,여자,여자,2
356,아가씨,2016-06-01,2016-08-04,64,8,7,1066,19.2,1293000,35195887491,205,4285703,2,"스릴러,드라마",씨제이이앤엠(주),남자,여자,여자,2
357,아가씨,2016-06-01,2016-08-05,65,7,6,1001,20.6,1365000,35197252491,206,4285909,2,"스릴러,드라마",씨제이이앤엠(주),남자,여자,여자,2
358,아가씨,2016-06-01,2016-08-06,66,9,8,1186,25.6,2205500,35199457991,303,4286212,2,"스릴러,드라마",씨제이이앤엠(주),남자,여자,여자,2
359,아가씨,2016-06-01,2016-08-07,67,9,8,1290,20.2,1819000,35201276991,261,4286473,2,"스릴러,드라마",씨제이이앤엠(주),남자,여자,여자,2
360,아가씨,2016-06-01,2016-08-08,68,9,7,1330,16.3,1330500,35202607491,217,4286690,2,"스릴러,드라마",씨제이이앤엠(주),남자,여자,여자,2
361,아가씨,2016-06-01,2016-08-09,69,7,6,1042,17.9,1139000,35203746491,186,4286876,2,"스릴러,드라마",씨제이이앤엠(주),남자,여자,여자,2
362,아가씨,2016-06-01,2016-08-10,70,10,9,1309,15.8,1277500,35205023991,207,4287083,2,"스릴러,드라마",씨제이이앤엠(주),남자,여자,여자,2
363,아가씨,2016-06-01,2016-08-11,71,5,5,489,7.8,264000,35205287991,38,4287121,2,"스릴러,드라마",씨제이이앤엠(주),남자,여자,여자,2
364,아가씨,2016-06-01,2016-08-12,72,3,3,324,10.2,288100,35205576091,33,4287154,2,"스릴러,드라마",씨제이이앤엠(주),남자,여자,여자,2
365,아가씨,2016-06-01,2016-08-13,73,5,5,506,20.4,881000,35206457091,103,4287257,2,"스릴러,드라마",씨제이이앤엠(주),남자,여자,여자,2
366,아가씨,2016-06-01,2016-08-14,74,4,4,475,19.6,810000,35207267091,93,4287350,2,"스릴러,드라마",씨제이이앤엠(주),남자,여자,여자,2
367,아가씨,2016-06-01,2016-08-15,75,5,4,569,14.1,715500,35207982591,80,4287430,2,"스릴러,드라마",씨제이이앤엠(주),남자,여자,여자,2
368,아가씨,2016-06-01,2016-08-16,76,4,4,400,6.5,205000,35208187591,26,4287456,2,"스릴러,드라마",씨제이이앤엠(주),남자,여자,여자,2
369,아가씨,2016-06-01,2016-08-17,77,4,4,448,5.6,157000,35208344591,25,4287481,2,"스릴러,드라마",씨제이이앤엠(주),남자,여자,여자,2
370,아가씨,2016-06-01,2016-08-18,78,1,1,160,13.1,150500,35208495091,21,4287502,2,"스릴러,드라마",씨제이이앤엠(주),남자,여자,여자,2
371,아가씨,2016-06-01,2016-08-19,79,1,1,160,19.4,268000,35208763091,31,4287533,2,"스릴러,드라마",씨제이이앤엠(주),남자,여자,여자,2
372,아가씨,2016-06-01,2016-08-20,80,1,1,160,44.4,655500,35209418591,71,4287604,2,"스릴러,드라마",씨제이이앤엠(주),남자,여자,여자,2
373,아가씨,2016-06-01,2016-08-21,81,2,2,210,11.9,223000,35209641591,25,4287629,2,"스릴러,드라마",씨제이이앤엠(주),남자,여자,여자,2
374,아가씨,2016-06-01,2016-08-22,82,1,1,160,18.1,221400,35209862991,29,4287658,2,"스릴러,드라마",씨제이이앤엠(주),남자,여자,여자,2
375,아가씨,2016-06-01,2016-08-23,83,1,1,160,33.8,397500,35210260491,54,4287712,2,"스릴러,드라마",씨제이이앤엠(주),남자,여자,여자,2
376,아가씨,2016-06-01,2016-08-24,84,1,1,160,16.3,189500,35210449991,26,4287738,2,"스릴러,드라마",씨제이이앤엠(주),남자,여자,여자,2
377,아가씨,2016-06-01,2016-08-25,85,1,1,108,27.8,239000,35210688991,30,4287768,2,"스릴러,드라마",씨제이이앤엠(주),남자,여자,여자,2
378,아가씨,2016-06-01,2016-08-26,86,1,1,108,5.6,40000,35210728991,6,4287774,2,"스릴러,드라마",씨제이이앤엠(주),남자,여자,여자,2
379,아가씨,2016-06-01,2016-08-27,87,1,1,108,10.2,77000,35210805991,11,4287785,2,"스릴러,드라마",씨제이이앤엠(주),남자,여자,여자,2
380,아가씨,2016-06-01,2016-08-28,88,1,1,108,15.7,114000,35210919991,17,4287802,2,"스릴러,드라마",씨제이이앤엠(주),남자,여자,여자,2
381,아가씨,2016-06-01,2016-08-29,89,1,1,108,9.3,83000,35211002991,10,4287812,2,"스릴러,드라마",씨제이이앤엠(주),남자,여자,여자,2
382,아가씨,2016-06-01,2016-08-30,90,1,1,108,5.6,50000,35211052991,6,4287818,2,"스릴러,드라마",씨제이이앤엠(주),남자,여자,여자,2
383,아가씨,2016-06-01,2016-08-31,91,1,1,108,5.6,47000,35211099991,6,4287824,2,"스릴러,드라마",씨제이이앤엠(주),남자,여자,여자,2
384,아가씨,2016-06-01,2016-09-02,93,1,1,160,3.1,41000,35211140991,5,4287829,2,"스릴러,드라마",씨제이이앤엠(주),남자,여자,여자,2
385,아가씨,2016-06-01,2016-09-03,94,1,1,160,6.3,89000,35211229991,10,4287839,2,"스릴러,드라마",씨제이이앤엠(주),남자,여자,여자,2
386,아가씨,2016-06-01,2017-02-12,256,1,1,432,87.0,3008000,35214237991,376,4288215,2,"스릴러,드라마",씨제이이앤엠(주),남자,여자,여자,2
387,아가씨,2016-06-01,2017-02-20,264,1,1,40,100.0,400000,35214637991,40,4288255,2,"스릴러,드라마",씨제이이앤엠(주),남자,여자,여자,2
388,아가씨,2016-06-01,2017-03-25,297,1,1,50,82.0,364000,35215001991,41,4288296,2,"스릴러,드라마",씨제이이앤엠(주),남자,여자,여자,2
389,아가씨,2016-06-01,2017-03-26,298,1,1,50,44.0,189000,35215190991,22,4288318,2,"스릴러,드라마",씨제이이앤엠(주),남자,여자,여자,2
390,아가씨,2016-06-01,2017-04-23,326,1,1,82,59.8,392000,35215582991,49,4288367,2,"스릴러,드라마",씨제이이앤엠(주),남자,여자,여자,2
391,아가씨,2016-06-01,2017-05-11,344,1,1,850,4.7,240000,35215822991,40,4288407,2,"스릴러,드라마",씨제이이앤엠(주),남자,여자,여자,2
392,아가씨,2016-06-01,2017-06-03,367,1,1,123,100.0,1230000,35217052991,123,4288530,2,"스릴러,드라마",씨제이이앤엠(주),남자,여자,여자,2
393,아가씨,2016-06-01,2018-02-28,637,1,1,72,40.3,256000,35217308991,29,4288559,2,"스릴러,드라마",씨제이이앤엠(주),남자,여자,여자,2
394,아가씨,2016-06-01,2018-03-03,640,1,1,72,44.4,308000,35217616991,32,4288591,2,"스릴러,드라마",씨제이이앤엠(주),남자,여자,여자,2
395,아가씨,2016-06-01,2018-03-29,666,2,2,202,25.7,438000,35218054991,52,4288643,2,"스릴러,드라마",씨제이이앤엠(주),남자,여자,여자,2
396,아가씨,2016-06-01,2018-03-30,667,2,2,132,25.8,311000,35218365991,34,4288677,2,"스릴러,드라마",씨제이이앤엠(주),남자,여자,여자,2
397,아가씨,2016-06-01,2018-03-31,668,2,2,123,59.4,763000,35219128991,73,4288750,2,"스릴러,드라마",씨제이이앤엠(주),남자,여자,여자,2
398,아가씨,2016-06-01,2018-09-01,822,1,1,75,100.0,825000,35219953991,75,4288825,2,"스릴러,드라마",씨제이이앤엠(주),남자,여자,여자,2
399,아가씨,2016-06-01,2018-10-19,870,1,1,212,0.0,0,35219953991,0,4288825,2,"스릴러,드라마",씨제이이앤엠(주),남자,여자,여자,2
400,아가씨,2016-06-01,2019-05-19,1082,1,1,152,29.0,469000,35220422991,44,4288869,2,"스릴러,드라마",씨제이이앤엠(주),남자,여자,여자,2
401,인천상륙작전,2016-07-27,2016-07-20,-7,7,6,1909,91.5,12638000,12638000,1746,1746,0,"전쟁,드라마",씨제이이앤엠(주),남자,남자,남자,0
402,인천상륙작전,2016-07-27,2016-07-21,-6,7,7,1067,100.0,9096000,21734000,1067,2813,0,"전쟁,드라마",씨제이이앤엠(주),남자,남자,남자,0
403,인천상륙작전,2016-07-27,2016-07-22,-5,9,9,1251,79.5,7439000,29173000,995,3808,0,"전쟁,드라마",씨제이이앤엠(주),남자,남자,남자,0
404,인천상륙작전,2016-07-27,2016-07-24,-3,1,1,174,100.0,1740000,30913000,174,3982,0,"전쟁,드라마",씨제이이앤엠(주),남자,남자,남자,0
405,인천상륙작전,2016-07-27,2016-07-25,-2,18,15,3232,100.0,26746000,57659000,3232,7214,0,"전쟁,드라마",씨제이이앤엠(주),남자,남자,남자,0
406,인천상륙작전,2016-07-27,2016-07-26,-1,34,32,6613,83.1,49568100,107227100,5497,12711,0,"전쟁,드라마",씨제이이앤엠(주),남자,남자,남자,0
407,인천상륙작전,2016-07-27,2016-07-27,0,4702,901,842680,55.1,2922521800,3029748900,464460,477171,0,"전쟁,드라마",씨제이이앤엠(주),남자,남자,남자,0
408,인천상륙작전,2016-07-27,2016-07-28,1,4803,904,849723,41.7,2635577800,5665326700,354500,831671,0,"전쟁,드라마",씨제이이앤엠(주),남자,남자,남자,0
409,인천상륙작전,2016-07-27,2016-07-29,2,5032,942,888883,45.6,3364992124,9030318824,405477,1237148,0,"전쟁,드라마",씨제이이앤엠(주),남자,남자,남자,0
410,인천상륙작전,2016-07-27,2016-07-30,3,5574,1038,983541,70.3,5741071923,14771390747,691478,1928626,0,"전쟁,드라마",씨제이이앤엠(주),남자,남자,남자,0
411,인천상륙작전,2016-07-27,2016-07-31,4,5666,1049,1011374,69.0,5844388660,20615779407,697945,2626571,0,"전쟁,드라마",씨제이이앤엠(주),남자,남자,남자,0
412,인천상륙작전,2016-07-27,2016-08-01,5,5609,995,1031623,48.0,3707436420,24323215827,495531,3122102,0,"전쟁,드라마",씨제이이앤엠(주),남자,남자,남자,0
413,인천상륙작전,2016-07-27,2016-08-02,6,5628,1013,1035268,44.7,3435641900,27758857727,462324,3584426,0,"전쟁,드라마",씨제이이앤엠(주),남자,남자,남자,0
414,인천상륙작전,2016-07-27,2016-08-03,7,3673,776,689006,46.4,2372148900,30131006627,319553,3903979,0,"전쟁,드라마",씨제이이앤엠(주),남자,남자,남자,0
415,인천상륙작전,2016-07-27,2016-08-04,8,3584,772,661794,39.8,1945025240,32076031867,263094,4167073,0,"전쟁,드라마",씨제이이앤엠(주),남자,남자,남자,0
416,인천상륙작전,2016-07-27,2016-08-05,9,3688,817,680457,40.1,2261338701,34337370568,273005,4440078,0,"전쟁,드라마",씨제이이앤엠(주),남자,남자,남자,0
417,인천상륙작전,2016-07-27,2016-08-06,10,3771,831,688762,60.1,3456337250,37793707818,413581,4853659,0,"전쟁,드라마",씨제이이앤엠(주),남자,남자,남자,0
418,인천상륙작전,2016-07-27,2016-08-07,11,3703,816,680239,57.6,3284964400,41078672218,391895,5245554,0,"전쟁,드라마",씨제이이앤엠(주),남자,남자,남자,0
419,인천상륙작전,2016-07-27,2016-08-08,12,3572,754,646129,26.2,1251919320,42330591538,169310,5414864,0,"전쟁,드라마",씨제이이앤엠(주),남자,남자,남자,0
420,인천상륙작전,2016-07-27,2016-08-09,13,3551,753,640847,23.5,1100966200,43431557738,150546,5565410,0,"전쟁,드라마",씨제이이앤엠(주),남자,남자,남자,0
421,인천상륙작전,2016-07-27,2016-08-10,14,2217,567,343341,30.3,751866100,44183423838,103963,5669373,0,"전쟁,드라마",씨제이이앤엠(주),남자,남자,남자,0
422,인천상륙작전,2016-07-27,2016-08-11,15,2199,549,342088,27.7,689709200,44873133038,94775,5764148,0,"전쟁,드라마",씨제이이앤엠(주),남자,남자,남자,0
423,인천상륙작전,2016-07-27,2016-08-12,16,2221,577,344707,29.5,823443516,45696576554,101838,5865986,0,"전쟁,드라마",씨제이이앤엠(주),남자,남자,남자,0
424,인천상륙작전,2016-07-27,2016-08-13,17,2104,588,321188,53.2,1424011399,47120587953,171009,6036995,0,"전쟁,드라마",씨제이이앤엠(주),남자,남자,남자,0
425,인천상륙작전,2016-07-27,2016-08-14,18,2079,581,314044,61.5,1630780300,48751368253,193124,6230119,0,"전쟁,드라마",씨제이이앤엠(주),남자,남자,남자,0
426,인천상륙작전,2016-07-27,2016-08-15,19,2064,586,310888,61.1,1560713900,50312082153,189850,6419969,0,"전쟁,드라마",씨제이이앤엠(주),남자,남자,남자,0
427,인천상륙작전,2016-07-27,2016-08-16,20,2018,546,302836,20.8,451309100,50763391253,62998,6482967,0,"전쟁,드라마",씨제이이앤엠(주),남자,남자,남자,0
428,인천상륙작전,2016-07-27,2016-08-17,21,1325,509,181918,23.7,302981400,51066372653,43044,6526011,0,"전쟁,드라마",씨제이이앤엠(주),남자,남자,남자,0
429,인천상륙작전,2016-07-27,2016-08-18,22,1320,538,180875,23.5,297162500,51363535153,42582,6568593,0,"전쟁,드라마",씨제이이앤엠(주),남자,남자,남자,0
430,인천상륙작전,2016-07-27,2016-08-19,23,1320,511,181777,23.0,332805600,51696340753,41876,6610469,0,"전쟁,드라마",씨제이이앤엠(주),남자,남자,남자,0
431,인천상륙작전,2016-07-27,2016-08-20,24,1304,511,179050,41.8,611746550,52308087303,74883,6685352,0,"전쟁,드라마",씨제이이앤엠(주),남자,남자,남자,0
432,인천상륙작전,2016-07-27,2016-08-21,25,1254,496,171782,44.8,637569400,52945656703,76883,6762235,0,"전쟁,드라마",씨제이이앤엠(주),남자,남자,남자,0
433,인천상륙작전,2016-07-27,2016-08-22,26,1313,472,183604,17.3,229604400,53175261103,31841,6794076,0,"전쟁,드라마",씨제이이앤엠(주),남자,남자,남자,0
434,인천상륙작전,2016-07-27,2016-08-23,27,1319,482,182811,15.6,202949100,53378210203,28570,6822646,0,"전쟁,드라마",씨제이이앤엠(주),남자,남자,남자,0
435,인천상륙작전,2016-07-27,2016-08-24,28,1135,441,153704,16.1,176291500,53554501703,24785,6847431,0,"전쟁,드라마",씨제이이앤엠(주),남자,남자,남자,0
436,인천상륙작전,2016-07-27,2016-08-25,29,794,374,112490,17.2,133978600,53688480303,19345,6866776,0,"전쟁,드라마",씨제이이앤엠(주),남자,남자,남자,0
437,인천상륙작전,2016-07-27,2016-08-26,30,797,378,109607,17.0,146378400,53834858703,18681,6885457,0,"전쟁,드라마",씨제이이앤엠(주),남자,남자,남자,0
438,인천상륙작전,2016-07-27,2016-08-27,31,841,396,115507,29.3,277340800,54112199503,33846,6919303,0,"전쟁,드라마",씨제이이앤엠(주),남자,남자,남자,0
439,인천상륙작전,2016-07-27,2016-08-28,32,812,394,112147,31.1,292068600,54404268103,34888,6954191,0,"전쟁,드라마",씨제이이앤엠(주),남자,남자,남자,0
440,인천상륙작전,2016-07-27,2016-08-29,33,786,378,107932,10.7,83187700,54487455803,11501,6965692,0,"전쟁,드라마",씨제이이앤엠(주),남자,남자,남자,0
441,인천상륙작전,2016-07-27,2016-08-30,34,774,376,107187,10.5,79896900,54567352703,11265,6976957,0,"전쟁,드라마",씨제이이앤엠(주),남자,남자,남자,0
442,인천상륙작전,2016-07-27,2016-08-31,35,574,290,76750,15.8,73946900,54641299603,12085,6989042,0,"전쟁,드라마",씨제이이앤엠(주),남자,남자,남자,0
443,인천상륙작전,2016-07-27,2016-09-01,36,561,278,73857,10.0,50724700,54692024303,7371,6996413,0,"전쟁,드라마",씨제이이앤엠(주),남자,남자,남자,0
444,인천상륙작전,2016-07-27,2016-09-02,37,552,272,70591,10.1,56837800,54748862103,7156,7003569,0,"전쟁,드라마",씨제이이앤엠(주),남자,남자,남자,0
445,인천상륙작전,2016-07-27,2016-09-03,38,581,283,73988,21.3,127843500,54876705603,15746,7019315,0,"전쟁,드라마",씨제이이앤엠(주),남자,남자,남자,0
446,인천상륙작전,2016-07-27,2016-09-04,39,557,283,71051,19.8,116731900,54993437503,14042,7033357,0,"전쟁,드라마",씨제이이앤엠(주),남자,남자,남자,0
447,인천상륙작전,2016-07-27,2016-09-05,40,574,292,73733,7.4,38224500,55031662003,5424,7038781,0,"전쟁,드라마",씨제이이앤엠(주),남자,남자,남자,0
448,인천상륙작전,2016-07-27,2016-09-06,41,565,288,72540,6.2,31154500,55062816503,4460,7043241,0,"전쟁,드라마",씨제이이앤엠(주),남자,남자,남자,0
449,인천상륙작전,2016-07-27,2016-09-07,42,63,53,7773,10.9,4621000,55067437503,845,7044086,0,"전쟁,드라마",씨제이이앤엠(주),남자,남자,남자,0
450,인천상륙작전,2016-07-27,2016-09-08,43,56,47,6798,4.9,2249000,55069686503,331,7044417,0,"전쟁,드라마",씨제이이앤엠(주),남자,남자,남자,0
451,인천상륙작전,2016-07-27,2016-09-09,44,50,40,5919,5.1,2184500,55071871003,302,7044719,0,"전쟁,드라마",씨제이이앤엠(주),남자,남자,남자,0
452,인천상륙작전,2016-07-27,2016-09-10,45,50,35,6267,8.3,4048300,55075919303,520,7045239,0,"전쟁,드라마",씨제이이앤엠(주),남자,남자,남자,0
453,인천상륙작전,2016-07-27,2016-09-11,46,48,36,5728,9.3,4380800,55080300103,535,7045774,0,"전쟁,드라마",씨제이이앤엠(주),남자,남자,남자,0
454,인천상륙작전,2016-07-27,2016-09-12,47,54,42,6887,5.4,2425000,55082725103,371,7046145,0,"전쟁,드라마",씨제이이앤엠(주),남자,남자,남자,0
455,인천상륙작전,2016-07-27,2016-09-13,48,38,27,4507,6.0,1781300,55084506403,272,7046417,0,"전쟁,드라마",씨제이이앤엠(주),남자,남자,남자,0
456,인천상륙작전,2016-07-27,2016-09-14,49,6,5,644,8.4,431900,55084938303,54,7046471,0,"전쟁,드라마",씨제이이앤엠(주),남자,남자,남자,0
457,인천상륙작전,2016-07-27,2016-09-15,50,4,4,376,30.1,888500,55085826803,113,7046584,0,"전쟁,드라마",씨제이이앤엠(주),남자,남자,남자,0
458,인천상륙작전,2016-07-27,2016-09-16,51,5,5,557,19.0,836000,55086662803,106,7046690,0,"전쟁,드라마",씨제이이앤엠(주),남자,남자,남자,0
459,인천상륙작전,2016-07-27,2016-09-17,52,4,4,403,24.3,684000,55087346803,98,7046788,0,"전쟁,드라마",씨제이이앤엠(주),남자,남자,남자,0
460,인천상륙작전,2016-07-27,2016-09-18,53,3,3,267,15.7,334000,55087680803,42,7046830,0,"전쟁,드라마",씨제이이앤엠(주),남자,남자,남자,0
461,인천상륙작전,2016-07-27,2016-09-19,54,4,3,420,6.7,166000,55087846803,28,7046858,0,"전쟁,드라마",씨제이이앤엠(주),남자,남자,남자,0
462,인천상륙작전,2016-07-27,2016-09-20,55,5,4,496,4.8,152000,55087998803,24,7046882,0,"전쟁,드라마",씨제이이앤엠(주),남자,남자,남자,0
463,인천상륙작전,2016-07-27,2016-09-21,56,2,2,156,9.6,85000,55088083803,15,7046897,0,"전쟁,드라마",씨제이이앤엠(주),남자,남자,남자,0
464,인천상륙작전,2016-07-27,2016-09-22,57,2,2,403,0.7,19000,55088102803,3,7046900,0,"전쟁,드라마",씨제이이앤엠(주),남자,남자,남자,0
465,인천상륙작전,2016-07-27,2016-09-23,58,2,2,316,3.2,56000,55088158803,10,7046910,0,"전쟁,드라마",씨제이이앤엠(주),남자,남자,남자,0
466,인천상륙작전,2016-07-27,2016-09-24,59,1,1,76,4.0,25000,55088183803,3,7046913,0,"전쟁,드라마",씨제이이앤엠(주),남자,남자,남자,0
467,인천상륙작전,2016-07-27,2016-09-25,60,1,1,226,2.7,30000,55088213803,6,7046919,0,"전쟁,드라마",씨제이이앤엠(주),남자,남자,남자,0
468,인천상륙작전,2016-07-27,2016-09-26,61,2,2,221,11.8,161000,55088374803,26,7046945,0,"전쟁,드라마",씨제이이앤엠(주),남자,남자,남자,0
469,인천상륙작전,2016-07-27,2016-09-27,62,2,2,316,2.9,51000,55088425803,9,7046954,0,"전쟁,드라마",씨제이이앤엠(주),남자,남자,남자,0
470,인천상륙작전,2016-07-27,2016-09-29,64,2,2,182,61.5,454000,55088879803,112,7047066,0,"전쟁,드라마",씨제이이앤엠(주),남자,남자,남자,0
471,인천상륙작전,2016-07-27,2016-09-30,65,1,1,72,6.9,39000,55088918803,5,7047071,0,"전쟁,드라마",씨제이이앤엠(주),남자,남자,남자,0
472,인천상륙작전,2016-07-27,2016-10-01,66,1,1,85,100.0,510000,55089428803,85,7047156,0,"전쟁,드라마",씨제이이앤엠(주),남자,남자,남자,0
473,인천상륙작전,2016-07-27,2016-10-04,69,1,1,72,5.6,30000,55089458803,4,7047160,0,"전쟁,드라마",씨제이이앤엠(주),남자,남자,남자,0
474,인천상륙작전,2016-07-27,2016-10-05,70,1,1,72,33.3,124000,55089582803,24,7047184,0,"전쟁,드라마",씨제이이앤엠(주),남자,남자,남자,0
475,인천상륙작전,2016-07-27,2016-10-07,72,1,1,72,13.9,52000,55089634803,10,7047194,0,"전쟁,드라마",씨제이이앤엠(주),남자,남자,남자,0
476,인천상륙작전,2016-07-27,2016-10-11,76,1,1,72,6.9,34500,55089669303,5,7047199,0,"전쟁,드라마",씨제이이앤엠(주),남자,남자,남자,0
477,인천상륙작전,2016-07-27,2016-10-13,78,1,1,173,92.5,640000,55090309303,160,7047359,0,"전쟁,드라마",씨제이이앤엠(주),남자,남자,남자,0
478,인천상륙작전,2016-07-27,2016-10-15,80,1,1,312,30.5,570000,55090879303,95,7047454,0,"전쟁,드라마",씨제이이앤엠(주),남자,남자,남자,0
479,인천상륙작전,2016-07-27,2016-10-18,83,1,1,122,39.3,240000,55091119303,48,7047502,0,"전쟁,드라마",씨제이이앤엠(주),남자,남자,남자,0
480,인천상륙작전,2016-07-27,2016-10-26,91,2,2,140,100.0,420000,55091539303,140,7047642,0,"전쟁,드라마",씨제이이앤엠(주),남자,남자,남자,0
481,인천상륙작전,2016-07-27,2016-11-14,110,1,1,183,79.8,730000,55092269303,146,7047788,0,"전쟁,드라마",씨제이이앤엠(주),남자,남자,남자,0
482,인천상륙작전,2016-07-27,2016-11-15,111,1,1,130,80.0,520000,55092789303,104,7047892,0,"전쟁,드라마",씨제이이앤엠(주),남자,남자,남자,0
483,인천상륙작전,2016-07-27,2016-11-16,112,1,1,183,79.8,730000,55093519303,146,7048038,0,"전쟁,드라마",씨제이이앤엠(주),남자,남자,남자,0
484,인천상륙작전,2016-07-27,2016-11-17,113,3,2,709,90.3,2706000,55096225303,640,7048678,0,"전쟁,드라마",씨제이이앤엠(주),남자,남자,남자,0
485,인천상륙작전,2016-07-27,2016-11-18,114,3,2,709,92.0,2754000,55098979303,652,7049330,0,"전쟁,드라마",씨제이이앤엠(주),남자,남자,남자,0
486,인천상륙작전,2016-07-27,2016-12-01,127,1,1,211,11.4,119000,55099098303,24,7049354,0,"전쟁,드라마",씨제이이앤엠(주),남자,남자,남자,0
487,인천상륙작전,2016-07-27,2016-12-09,135,1,1,183,100.0,1464000,55100562303,183,7049537,0,"전쟁,드라마",씨제이이앤엠(주),남자,남자,남자,0
488,인천상륙작전,2016-07-27,2016-12-14,140,1,1,106,100.0,848000,55101410303,106,7049643,0,"전쟁,드라마",씨제이이앤엠(주),남자,남자,남자,0
489,인천상륙작전,2016-07-27,2017-02-09,197,1,1,211,100.0,1266000,55102676303,211,7049854,0,"전쟁,드라마",씨제이이앤엠(주),남자,남자,남자,0
490,인천상륙작전,2016-07-27,2017-04-13,260,1,1,413,1.2,22000,55102698303,5,7049859,0,"전쟁,드라마",씨제이이앤엠(주),남자,남자,남자,0
491,인천상륙작전,2016-07-27,2017-04-15,262,1,1,413,1.7,42000,55102740303,7,7049866,0,"전쟁,드라마",씨제이이앤엠(주),남자,남자,남자,0
492,인천상륙작전,2016-07-27,2017-04-16,263,1,1,413,0.7,15000,55102755303,3,7049869,0,"전쟁,드라마",씨제이이앤엠(주),남자,남자,남자,0
493,인천상륙작전,2016-07-27,2017-06-07,315,1,1,162,74.1,720000,55103475303,120,7049989,0,"전쟁,드라마",씨제이이앤엠(주),남자,남자,남자,0
494,인천상륙작전,2016-07-27,2017-06-08,316,1,1,99,70.7,420000,55103895303,70,7050059,0,"전쟁,드라마",씨제이이앤엠(주),남자,남자,남자,0
495,인천상륙작전,2016-07-27,2017-06-19,327,1,1,167,89.8,600000,55104495303,150,7050209,0,"전쟁,드라마",씨제이이앤엠(주),남자,남자,남자,0
496,인천상륙작전,2016-07-27,2017-06-22,330,1,1,167,59.9,400000,55104895303,100,7050309,0,"전쟁,드라마",씨제이이앤엠(주),남자,남자,남자,0
497,인천상륙작전,2016-07-27,2017-06-24,332,1,1,167,91.6,618000,55105513303,153,7050462,0,"전쟁,드라마",씨제이이앤엠(주),남자,남자,남자,0
498,인천상륙작전,2016-07-27,2017-06-26,334,1,1,96,6.3,39000,55105552303,6,7050468,0,"전쟁,드라마",씨제이이앤엠(주),남자,남자,남자,0
499,인천상륙작전,2016-07-27,2017-06-27,335,1,1,110,1.8,18000,55105570303,2,7050470,0,"전쟁,드라마",씨제이이앤엠(주),남자,남자,남자,0
500,인천상륙작전,2016-07-27,2017-06-29,337,1,1,110,2.7,27000,55105597303,3,7050473,0,"전쟁,드라마",씨제이이앤엠(주),남자,남자,남자,0
501,인천상륙작전,2016-07-27,2017-06-30,338,1,1,152,1.3,9000,55105606303,2,7050475,0,"전쟁,드라마",씨제이이앤엠(주),남자,남자,남자,0
502,인천상륙작전,2016-07-27,2019-02-18,936,2,2,675,100.0,6200000,55111806303,675,7051150,0,"전쟁,드라마",씨제이이앤엠(주),남자,남자,남자,0
503,덕혜옹주,2016-08-03,2016-07-26,-8,1,1,151,100.0,1057000,1057000,151,151,1,"사극,드라마",롯데컬처웍스(주)롯데엔터테인먼트,남자,남자,여자,1
504,덕혜옹주,2016-08-03,2016-07-27,-7,5,5,1365,100.0,10920000,11977000,1365,1516,1,"사극,드라마",롯데컬처웍스(주)롯데엔터테인먼트,남자,남자,여자,1
505,덕혜옹주,2016-08-03,2016-07-28,-6,24,24,4018,33.6,10643000,22620000,1349,2865,1,"사극,드라마",롯데컬처웍스(주)롯데엔터테인먼트,남자,남자,여자,1
506,덕혜옹주,2016-08-03,2016-07-29,-5,9,9,1722,85.5,13693000,36313000,1473,4338,1,"사극,드라마",롯데컬처웍스(주)롯데엔터테인먼트,남자,남자,여자,1
507,덕혜옹주,2016-08-03,2016-07-30,-4,7,7,1340,100.0,13374000,49687000,1340,5678,1,"사극,드라마",롯데컬처웍스(주)롯데엔터테인먼트,남자,남자,여자,1
508,덕혜옹주,2016-08-03,2016-08-01,-2,19,19,3855,80.5,28799500,78486500,3103,8781,1,"사극,드라마",롯데컬처웍스(주)롯데엔터테인먼트,남자,남자,여자,1
509,덕혜옹주,2016-08-03,2016-08-02,-1,25,24,6180,99.7,53088000,131574500,6162,14943,1,"사극,드라마",롯데컬처웍스(주)롯데엔터테인먼트,남자,남자,여자,1
510,덕혜옹주,2016-08-03,2016-08-03,0,3458,774,622937,42.9,1980965300,2112539800,267112,282055,1,"사극,드라마",롯데컬처웍스(주)롯데엔터테인먼트,남자,남자,여자,1
511,덕혜옹주,2016-08-03,2016-08-04,1,3320,771,593984,42.8,1881699200,3994239000,254034,536089,1,"사극,드라마",롯데컬처웍스(주)롯데엔터테인먼트,남자,남자,여자,1
512,덕혜옹주,2016-08-03,2016-08-05,2,3422,827,605215,46.7,2346373744,6340612744,282765,818854,1,"사극,드라마",롯데컬처웍스(주)롯데엔터테인먼트,남자,남자,여자,1
513,덕혜옹주,2016-08-03,2016-08-06,3,3811,937,670643,66.6,3738631015,10079243759,446343,1265197,1,"사극,드라마",롯데컬처웍스(주)롯데엔터테인먼트,남자,남자,여자,1
514,덕혜옹주,2016-08-03,2016-08-07,4,3878,964,686059,64.3,3707568100,13786811859,441268,1706465,1,"사극,드라마",롯데컬처웍스(주)롯데엔터테인먼트,남자,남자,여자,1
515,덕혜옹주,2016-08-03,2016-08-08,5,3907,897,730106,34.6,1875575020,15662386879,252925,1959390,1,"사극,드라마",롯데컬처웍스(주)롯데엔터테인먼트,남자,남자,여자,1
516,덕혜옹주,2016-08-03,2016-08-09,6,3924,910,738433,33.8,1840567900,17502954779,249618,2209008,1,"사극,드라마",롯데컬처웍스(주)롯데엔터테인먼트,남자,남자,여자,1
517,덕혜옹주,2016-08-03,2016-08-10,7,3174,748,587833,32.3,1397670900,18900625679,189829,2398837,1,"사극,드라마",롯데컬처웍스(주)롯데엔터테인먼트,남자,남자,여자,1
518,덕혜옹주,2016-08-03,2016-08-11,8,3270,784,605242,30.3,1348073900,20248699579,183554,2582391,1,"사극,드라마",롯데컬처웍스(주)롯데엔터테인먼트,남자,남자,여자,1
519,덕혜옹주,2016-08-03,2016-08-12,9,3410,803,629137,32.9,1697824816,21946524395,206964,2789355,1,"사극,드라마",롯데컬처웍스(주)롯데엔터테인먼트,남자,남자,여자,1
520,덕혜옹주,2016-08-03,2016-08-13,10,3521,827,640241,55.7,2985522899,24932047294,356839,3146194,1,"사극,드라마",롯데컬처웍스(주)롯데엔터테인먼트,남자,남자,여자,1
521,덕혜옹주,2016-08-03,2016-08-14,11,3515,814,640832,63.1,3415241760,28347289054,404130,3550324,1,"사극,드라마",롯데컬처웍스(주)롯데엔터테인먼트,남자,남자,여자,1
522,덕혜옹주,2016-08-03,2016-08-15,12,3512,849,639611,63.8,3363548420,31710837474,408342,3958666,1,"사극,드라마",롯데컬처웍스(주)롯데엔터테인먼트,남자,남자,여자,1
523,덕혜옹주,2016-08-03,2016-08-16,13,3310,750,604261,24.3,1060989100,32771826574,147020,4105686,1,"사극,드라마",롯데컬처웍스(주)롯데엔터테인먼트,남자,남자,여자,1
524,덕혜옹주,2016-08-03,2016-08-17,14,2642,660,432393,26.8,843811700,33615638274,115934,4221620,1,"사극,드라마",롯데컬처웍스(주)롯데엔터테인먼트,남자,남자,여자,1
525,덕혜옹주,2016-08-03,2016-08-18,15,2668,676,434753,25.1,793099300,34408737574,109224,4330844,1,"사극,드라마",롯데컬처웍스(주)롯데엔터테인먼트,남자,남자,여자,1
526,덕혜옹주,2016-08-03,2016-08-19,16,2787,696,455927,24.6,910579050,35319316624,112075,4442919,1,"사극,드라마",롯데컬처웍스(주)롯데엔터테인먼트,남자,남자,여자,1
527,덕혜옹주,2016-08-03,2016-08-20,17,2979,722,499176,41.2,1710450765,37029767389,205879,4648798,1,"사극,드라마",롯데컬처웍스(주)롯데엔터테인먼트,남자,남자,여자,1
528,덕혜옹주,2016-08-03,2016-08-21,18,2882,709,483677,38.0,1536813700,38566581089,183890,4832688,1,"사극,드라마",롯데컬처웍스(주)롯데엔터테인먼트,남자,남자,여자,1
529,덕혜옹주,2016-08-03,2016-08-22,19,2746,664,458869,15.3,507685200,39074266289,70050,4902738,1,"사극,드라마",롯데컬처웍스(주)롯데엔터테인먼트,남자,남자,여자,1
530,덕혜옹주,2016-08-03,2016-08-23,20,2728,672,458789,14.7,485708500,39559974789,67270,4970008,1,"사극,드라마",롯데컬처웍스(주)롯데엔터테인먼트,남자,남자,여자,1
531,덕혜옹주,2016-08-03,2016-08-24,21,2389,597,421088,13.2,402551300,39962526089,55709,5025717,1,"사극,드라마",롯데컬처웍스(주)롯데엔터테인먼트,남자,남자,여자,1
532,덕혜옹주,2016-08-03,2016-08-25,22,1958,496,356394,14.1,358375200,40320901289,50082,5075799,1,"사극,드라마",롯데컬처웍스(주)롯데엔터테인먼트,남자,남자,여자,1
533,덕혜옹주,2016-08-03,2016-08-26,23,1993,506,363067,14.5,423319600,40744220889,52784,5128583,1,"사극,드라마",롯데컬처웍스(주)롯데엔터테인먼트,남자,남자,여자,1
534,덕혜옹주,2016-08-03,2016-08-27,24,2100,551,379475,24.5,770035400,41514256289,92992,5221575,1,"사극,드라마",롯데컬처웍스(주)롯데엔터테인먼트,남자,남자,여자,1
535,덕혜옹주,2016-08-03,2016-08-28,25,2006,536,360201,23.5,706808600,42221064889,84746,5306321,1,"사극,드라마",롯데컬처웍스(주)롯데엔터테인먼트,남자,남자,여자,1
536,덕혜옹주,2016-08-03,2016-08-29,26,1917,504,337035,8.8,212978000,42434042889,29635,5335956,1,"사극,드라마",롯데컬처웍스(주)롯데엔터테인먼트,남자,남자,여자,1
537,덕혜옹주,2016-08-03,2016-08-30,27,1910,520,333692,9.4,220257800,42654300689,31275,5367231,1,"사극,드라마",롯데컬처웍스(주)롯데엔터테인먼트,남자,남자,여자,1
538,덕혜옹주,2016-08-03,2016-08-31,28,1469,487,228371,18.0,239001100,42893301789,41095,5408326,1,"사극,드라마",롯데컬처웍스(주)롯데엔터테인먼트,남자,남자,여자,1
539,덕혜옹주,2016-08-03,2016-09-01,29,1438,462,216564,9.2,139997600,43033299389,19913,5428239,1,"사극,드라마",롯데컬처웍스(주)롯데엔터테인먼트,남자,남자,여자,1
540,덕혜옹주,2016-08-03,2016-09-02,30,1492,466,221939,10.0,178101800,43211401189,22246,5450485,1,"사극,드라마",롯데컬처웍스(주)롯데엔터테인먼트,남자,남자,여자,1
541,덕혜옹주,2016-08-03,2016-09-03,31,1547,480,234008,17.8,344397220,43555798409,41587,5492072,1,"사극,드라마",롯데컬처웍스(주)롯데엔터테인먼트,남자,남자,여자,1
542,덕혜옹주,2016-08-03,2016-09-04,32,1496,470,227192,16.2,307115700,43862914109,36873,5528945,1,"사극,드라마",롯데컬처웍스(주)롯데엔터테인먼트,남자,남자,여자,1
543,덕혜옹주,2016-08-03,2016-09-05,33,1434,455,209922,6.0,90304500,43953218609,12616,5541561,1,"사극,드라마",롯데컬처웍스(주)롯데엔터테인먼트,남자,남자,여자,1
544,덕혜옹주,2016-08-03,2016-09-06,34,1372,461,202575,5.8,81854000,44035072609,11660,5553221,1,"사극,드라마",롯데컬처웍스(주)롯데엔터테인먼트,남자,남자,여자,1
545,덕혜옹주,2016-08-03,2016-09-07,35,391,259,49089,4.9,16116400,44051189009,2379,5555600,1,"사극,드라마",롯데컬처웍스(주)롯데엔터테인먼트,남자,남자,여자,1
546,덕혜옹주,2016-08-03,2016-09-08,36,399,269,49157,5.2,17676400,44068865409,2565,5558165,1,"사극,드라마",롯데컬처웍스(주)롯데엔터테인먼트,남자,남자,여자,1
547,덕혜옹주,2016-08-03,2016-09-09,37,415,272,50756,4.8,18761200,44087626609,2443,5560608,1,"사극,드라마",롯데컬처웍스(주)롯데엔터테인먼트,남자,남자,여자,1
548,덕혜옹주,2016-08-03,2016-09-10,38,365,237,44415,9.0,33238900,44120865509,4003,5564611,1,"사극,드라마",롯데컬처웍스(주)롯데엔터테인먼트,남자,남자,여자,1
549,덕혜옹주,2016-08-03,2016-09-11,39,361,241,43217,9.5,34217500,44155083009,4108,5568719,1,"사극,드라마",롯데컬처웍스(주)롯데엔터테인먼트,남자,남자,여자,1
550,덕혜옹주,2016-08-03,2016-09-12,40,356,233,44061,4.5,13876500,44168959509,1969,5570688,1,"사극,드라마",롯데컬처웍스(주)롯데엔터테인먼트,남자,남자,여자,1
551,덕혜옹주,2016-08-03,2016-09-13,41,299,211,37945,4.6,12198500,44181158009,1735,5572423,1,"사극,드라마",롯데컬처웍스(주)롯데엔터테인먼트,남자,남자,여자,1
552,덕혜옹주,2016-08-03,2016-09-14,42,172,132,21113,13.3,24751500,44205909509,2806,5575229,1,"사극,드라마",롯데컬처웍스(주)롯데엔터테인먼트,남자,남자,여자,1
553,덕혜옹주,2016-08-03,2016-09-15,43,161,126,19726,25.1,44833500,44250743009,4959,5580188,1,"사극,드라마",롯데컬처웍스(주)롯데엔터테인먼트,남자,남자,여자,1
554,덕혜옹주,2016-08-03,2016-09-16,44,152,123,18813,30.8,50694300,44301437309,5802,5585990,1,"사극,드라마",롯데컬처웍스(주)롯데엔터테인먼트,남자,남자,여자,1
555,덕혜옹주,2016-08-03,2016-09-17,45,139,113,16937,23.5,33860300,44335297609,3979,5589969,1,"사극,드라마",롯데컬처웍스(주)롯데엔터테인먼트,남자,남자,여자,1
556,덕혜옹주,2016-08-03,2016-09-18,46,125,108,14929,13.2,16561000,44351858609,1968,5591937,1,"사극,드라마",롯데컬처웍스(주)롯데엔터테인먼트,남자,남자,여자,1
557,덕혜옹주,2016-08-03,2016-09-19,47,131,100,16058,4.6,4985500,44356844109,741,5592678,1,"사극,드라마",롯데컬처웍스(주)롯데엔터테인먼트,남자,남자,여자,1
558,덕혜옹주,2016-08-03,2016-09-20,48,124,102,15708,4.0,4159000,44361003109,629,5593307,1,"사극,드라마",롯데컬처웍스(주)롯데엔터테인먼트,남자,남자,여자,1
559,덕혜옹주,2016-08-03,2016-09-21,49,75,61,9948,5.5,3911000,44364914109,543,5593850,1,"사극,드라마",롯데컬처웍스(주)롯데엔터테인먼트,남자,남자,여자,1
560,덕혜옹주,2016-08-03,2016-09-22,50,19,14,2554,7.3,1405500,44366319609,186,5594036,1,"사극,드라마",롯데컬처웍스(주)롯데엔터테인먼트,남자,남자,여자,1
561,덕혜옹주,2016-08-03,2016-09-23,51,23,16,2765,22.4,3593000,44369912609,619,5594655,1,"사극,드라마",롯데컬처웍스(주)롯데엔터테인먼트,남자,남자,여자,1
562,덕혜옹주,2016-08-03,2016-09-24,52,14,13,1876,9.7,1464000,44371376609,181,5594836,1,"사극,드라마",롯데컬처웍스(주)롯데엔터테인먼트,남자,남자,여자,1
563,덕혜옹주,2016-08-03,2016-09-25,53,16,13,2211,5.8,1032000,44372408609,129,5594965,1,"사극,드라마",롯데컬처웍스(주)롯데엔터테인먼트,남자,남자,여자,1
564,덕혜옹주,2016-08-03,2016-09-26,54,23,18,2703,5.4,1042000,44373450609,147,5595112,1,"사극,드라마",롯데컬처웍스(주)롯데엔터테인먼트,남자,남자,여자,1
565,덕혜옹주,2016-08-03,2016-09-27,55,24,15,2727,11.5,1948500,44375399109,314,5595426,1,"사극,드라마",롯데컬처웍스(주)롯데엔터테인먼트,남자,남자,여자,1
566,덕혜옹주,2016-08-03,2016-09-28,56,7,7,927,31.3,2001000,44377400109,290,5595716,1,"사극,드라마",롯데컬처웍스(주)롯데엔터테인먼트,남자,남자,여자,1
567,덕혜옹주,2016-08-03,2016-09-29,57,5,5,589,13.2,536500,44377936609,78,5595794,1,"사극,드라마",롯데컬처웍스(주)롯데엔터테인먼트,남자,남자,여자,1
568,덕혜옹주,2016-08-03,2016-09-30,58,5,5,589,13.4,606500,44378543109,79,5595873,1,"사극,드라마",롯데컬처웍스(주)롯데엔터테인먼트,남자,남자,여자,1
569,덕혜옹주,2016-08-03,2016-10-06,64,1,1,312,96.2,1800000,44380343109,300,5596173,1,"사극,드라마",롯데컬처웍스(주)롯데엔터테인먼트,남자,남자,여자,1
570,덕혜옹주,2016-08-03,2016-10-07,65,2,2,357,38.7,852000,44381195109,138,5596311,1,"사극,드라마",롯데컬처웍스(주)롯데엔터테인먼트,남자,남자,여자,1
571,덕혜옹주,2016-08-03,2016-10-11,69,1,1,36,83.3,150000,44381345109,30,5596341,1,"사극,드라마",롯데컬처웍스(주)롯데엔터테인먼트,남자,남자,여자,1
572,덕혜옹주,2016-08-03,2016-10-12,70,2,2,251,29.9,335000,44381680109,75,5596416,1,"사극,드라마",롯데컬처웍스(주)롯데엔터테인먼트,남자,남자,여자,1
573,덕혜옹주,2016-08-03,2016-10-13,71,3,3,347,91.4,1507000,44383187109,317,5596733,1,"사극,드라마",롯데컬처웍스(주)롯데엔터테인먼트,남자,남자,여자,1
574,덕혜옹주,2016-08-03,2016-10-14,72,1,1,207,100.0,828000,44384015109,207,5596940,1,"사극,드라마",롯데컬처웍스(주)롯데엔터테인먼트,남자,남자,여자,1
575,덕혜옹주,2016-08-03,2016-10-16,74,1,1,136,85.3,696000,44384711109,116,5597056,1,"사극,드라마",롯데컬처웍스(주)롯데엔터테인먼트,남자,남자,여자,1
576,덕혜옹주,2016-08-03,2016-10-18,76,1,1,126,100.0,504000,44385215109,126,5597182,1,"사극,드라마",롯데컬처웍스(주)롯데엔터테인먼트,남자,남자,여자,1
577,덕혜옹주,2016-08-03,2016-10-24,82,1,1,169,0.0,0,44385215109,0,5597182,1,"사극,드라마",롯데컬처웍스(주)롯데엔터테인먼트,남자,남자,여자,1
578,덕혜옹주,2016-08-03,2016-10-25,83,1,1,163,30.7,350000,44385565109,50,5597232,1,"사극,드라마",롯데컬처웍스(주)롯데엔터테인먼트,남자,남자,여자,1
579,덕혜옹주,2016-08-03,2016-11-01,90,2,1,520,31.4,326000,44385891109,163,5597395,1,"사극,드라마",롯데컬처웍스(주)롯데엔터테인먼트,남자,남자,여자,1
580,덕혜옹주,2016-08-03,2016-11-02,91,2,1,520,43.9,456000,44386347109,228,5597623,1,"사극,드라마",롯데컬처웍스(주)롯데엔터테인먼트,남자,남자,여자,1
581,덕혜옹주,2016-08-03,2016-11-17,106,3,2,632,93.4,2372000,44388719109,590,5598213,1,"사극,드라마",롯데컬처웍스(주)롯데엔터테인먼트,남자,남자,여자,1
582,덕혜옹주,2016-08-03,2016-11-18,107,2,1,522,92.2,1924000,44390643109,481,5598694,1,"사극,드라마",롯데컬처웍스(주)롯데엔터테인먼트,남자,남자,여자,1
583,덕혜옹주,2016-08-03,2016-11-25,114,3,2,324,21.3,345000,44390988109,69,5598763,1,"사극,드라마",롯데컬처웍스(주)롯데엔터테인먼트,남자,남자,여자,1
584,덕혜옹주,2016-08-03,2016-11-29,118,1,1,182,0.0,0,44390988109,0,5598763,1,"사극,드라마",롯데컬처웍스(주)롯데엔터테인먼트,남자,남자,여자,1
585,덕혜옹주,2016-08-03,2016-12-01,120,1,1,138,0.0,0,44390988109,0,5598763,1,"사극,드라마",롯데컬처웍스(주)롯데엔터테인먼트,남자,남자,여자,1
586,덕혜옹주,2016-08-03,2016-12-02,121,1,1,116,0.0,0,44390988109,0,5598763,1,"사극,드라마",롯데컬처웍스(주)롯데엔터테인먼트,남자,남자,여자,1
587,덕혜옹주,2016-08-03,2016-12-08,127,1,1,254,80.3,1530000,44392518109,204,5598967,1,"사극,드라마",롯데컬처웍스(주)롯데엔터테인먼트,남자,남자,여자,1
588,덕혜옹주,2016-08-03,2016-12-16,135,2,2,286,91.6,1310000,44393828109,262,5599229,1,"사극,드라마",롯데컬처웍스(주)롯데엔터테인먼트,남자,남자,여자,1
589,덕혜옹주,2016-08-03,2016-12-22,141,1,1,102,0.0,0,44393828109,0,5599229,1,"사극,드라마",롯데컬처웍스(주)롯데엔터테인먼트,남자,남자,여자,1
590,덕혜옹주,2016-08-03,2016-12-23,142,2,2,375,0.0,0,44393828109,0,5599229,1,"사극,드라마",롯데컬처웍스(주)롯데엔터테인먼트,남자,남자,여자,1
591,덕혜옹주,2016-08-03,2016-12-24,143,1,1,173,0.0,0,44393828109,0,5599229,1,"사극,드라마",롯데컬처웍스(주)롯데엔터테인먼트,남자,남자,여자,1
592,덕혜옹주,2016-08-03,2017-03-16,225,1,1,221,0.0,0,44393828109,0,5599229,1,"사극,드라마",롯데컬처웍스(주)롯데엔터테인먼트,남자,남자,여자,1
593,덕혜옹주,2016-08-03,2017-03-17,226,1,1,155,0.0,0,44393828109,0,5599229,1,"사극,드라마",롯데컬처웍스(주)롯데엔터테인먼트,남자,남자,여자,1
594,덕혜옹주,2016-08-03,2017-04-12,252,1,1,413,1.7,37000,44393865109,7,5599236,1,"사극,드라마",롯데컬처웍스(주)롯데엔터테인먼트,남자,남자,여자,1
595,덕혜옹주,2016-08-03,2017-04-13,253,1,1,413,0.7,16000,44393881109,3,5599239,1,"사극,드라마",롯데컬처웍스(주)롯데엔터테인먼트,남자,남자,여자,1
596,덕혜옹주,2016-08-03,2017-04-16,256,1,1,413,6.8,172000,44394053109,28,5599267,1,"사극,드라마",롯데컬처웍스(주)롯데엔터테인먼트,남자,남자,여자,1
597,덕혜옹주,2016-08-03,2017-05-25,295,1,1,156,83.3,650000,44394703109,130,5599397,1,"사극,드라마",롯데컬처웍스(주)롯데엔터테인먼트,남자,남자,여자,1
598,덕혜옹주,2016-08-03,2017-06-20,321,1,1,122,0.0,0,44394703109,0,5599397,1,"사극,드라마",롯데컬처웍스(주)롯데엔터테인먼트,남자,남자,여자,1
599,덕혜옹주,2016-08-03,2017-06-23,324,1,1,167,59.9,400000,44395103109,100,5599497,1,"사극,드라마",롯데컬처웍스(주)롯데엔터테인먼트,남자,남자,여자,1
600,덕혜옹주,2016-08-03,2017-06-25,326,1,1,167,65.3,451500,44395554609,109,5599606,1,"사극,드라마",롯데컬처웍스(주)롯데엔터테인먼트,남자,남자,여자,1
601,덕혜옹주,2016-08-03,2017-06-29,330,1,1,308,0.0,0,44395554609,0,5599606,1,"사극,드라마",롯데컬처웍스(주)롯데엔터테인먼트,남자,남자,여자,1
602,덕혜옹주,2016-08-03,2017-07-14,345,1,1,59,100.0,413000,44395967609,59,5599665,1,"사극,드라마",롯데컬처웍스(주)롯데엔터테인먼트,남자,남자,여자,1
603,덕혜옹주,2016-08-03,2018-10-18,806,2,2,560,58.9,1650000,44397617609,330,5599995,1,"사극,드라마",롯데컬처웍스(주)롯데엔터테인먼트,남자,남자,여자,1
604,아수라,2016-09-28,2016-09-21,-7,9,5,2203,91.1,13860000,13860000,2007,2007,0,"범죄,액션",씨제이이앤엠(주),남자,남자,남자,0
605,아수라,2016-09-28,2016-09-23,-5,31,30,7184,99.9,66160000,80020000,7175,9182,0,"범죄,액션",씨제이이앤엠(주),남자,남자,남자,0
606,아수라,2016-09-28,2016-09-26,-2,48,44,9822,98.8,84348000,164368000,9702,18884,0,"범죄,액션",씨제이이앤엠(주),남자,남자,남자,0
607,아수라,2016-09-28,2016-09-27,-1,34,32,6720,88.7,57001000,221369000,5962,24846,0,"범죄,액션",씨제이이앤엠(주),남자,남자,남자,0
608,아수라,2016-09-28,2016-09-28,0,5731,1262,1134268,41.9,2907847000,3129216000,475482,500328,0,"범죄,액션",씨제이이앤엠(주),남자,남자,남자,0
609,아수라,2016-09-28,2016-09-29,1,5802,1190,1143610,20.4,1745192570,4874408570,233804,734132,0,"범죄,액션",씨제이이앤엠(주),남자,남자,남자,0
610,아수라,2016-09-28,2016-09-30,2,6082,1242,1199373,20.2,2002165161,6876573731,241877,976009,0,"범죄,액션",씨제이이앤엠(주),남자,남자,남자,0
611,아수라,2016-09-28,2016-10-01,3,6501,1278,1274813,30.9,3429938471,10306512202,394406,1370415,0,"범죄,액션",씨제이이앤엠(주),남자,남자,남자,0
612,아수라,2016-09-28,2016-10-02,4,6199,1248,1222430,35.4,3770794860,14077307062,432276,1802691,0,"범죄,액션",씨제이이앤엠(주),남자,남자,남자,0
613,아수라,2016-09-28,2016-10-03,5,5609,1184,1110174,25.1,2398718100,16476025162,278180,2080871,0,"범죄,액션",씨제이이앤엠(주),남자,남자,남자,0
614,아수라,2016-09-28,2016-10-04,6,4921,1041,942816,8.0,570440900,17046466062,75757,2156628,0,"범죄,액션",씨제이이앤엠(주),남자,남자,남자,0
615,아수라,2016-09-28,2016-10-05,7,3632,819,635502,9.8,469843000,17516309062,62284,2218912,0,"범죄,액션",씨제이이앤엠(주),남자,남자,남자,0
616,아수라,2016-09-28,2016-10-06,8,3024,739,522954,8.6,339769100,17856078162,45189,2264101,0,"범죄,액션",씨제이이앤엠(주),남자,남자,남자,0
617,아수라,2016-09-28,2016-10-07,9,2953,721,501878,9.6,410459100,18266537262,48309,2312410,0,"범죄,액션",씨제이이앤엠(주),남자,남자,남자,0
618,아수라,2016-09-28,2016-10-08,10,2638,716,445230,19.6,763599000,19030136262,87276,2399686,0,"범죄,액션",씨제이이앤엠(주),남자,남자,남자,0
619,아수라,2016-09-28,2016-10-09,11,2496,697,418508,17.2,631886600,19662022862,71838,2471524,0,"범죄,액션",씨제이이앤엠(주),남자,남자,남자,0
620,아수라,2016-09-28,2016-10-10,12,2485,623,392836,7.0,205529600,19867552462,27357,2498881,0,"범죄,액션",씨제이이앤엠(주),남자,남자,남자,0
621,아수라,2016-09-28,2016-10-11,13,2401,633,375810,6.0,168896700,20036449162,22604,2521485,0,"범죄,액션",씨제이이앤엠(주),남자,남자,남자,0
622,아수라,2016-09-28,2016-10-12,14,2385,623,375643,5.9,140314000,20176763162,21994,2543479,0,"범죄,액션",씨제이이앤엠(주),남자,남자,남자,0
623,아수라,2016-09-28,2016-10-13,15,827,376,103449,6.3,48322900,20225086062,6462,2549941,0,"범죄,액션",씨제이이앤엠(주),남자,남자,남자,0
624,아수라,2016-09-28,2016-10-14,16,822,370,102192,6.6,55775100,20280861162,6736,2556677,0,"범죄,액션",씨제이이앤엠(주),남자,남자,남자,0
625,아수라,2016-09-28,2016-10-15,17,744,376,94722,11.1,90192800,20371053962,10556,2567233,0,"범죄,액션",씨제이이앤엠(주),남자,남자,남자,0
626,아수라,2016-09-28,2016-10-16,18,680,356,85912,11.6,86605700,20457659662,9939,2577172,0,"범죄,액션",씨제이이앤엠(주),남자,남자,남자,0
627,아수라,2016-09-28,2016-10-17,19,727,355,92059,5.1,35332400,20492992062,4660,2581832,0,"범죄,액션",씨제이이앤엠(주),남자,남자,남자,0
628,아수라,2016-09-28,2016-10-18,20,682,343,88144,5.0,30444100,20523436162,4385,2586217,0,"범죄,액션",씨제이이앤엠(주),남자,남자,남자,0
629,아수라,2016-09-28,2016-10-19,21,173,111,21670,5.5,8367900,20531804062,1181,2587398,0,"범죄,액션",씨제이이앤엠(주),남자,남자,남자,0
630,아수라,2016-09-28,2016-10-20,22,68,55,8869,12.5,5954100,20537758162,1105,2588503,0,"범죄,액션",씨제이이앤엠(주),남자,남자,남자,0
631,아수라,2016-09-28,2016-10-21,23,54,45,7193,10.4,6177000,20543935162,748,2589251,0,"범죄,액션",씨제이이앤엠(주),남자,남자,남자,0
632,아수라,2016-09-28,2016-10-22,24,44,40,5970,10.0,4613500,20548548662,599,2589850,0,"범죄,액션",씨제이이앤엠(주),남자,남자,남자,0
633,아수라,2016-09-28,2016-10-23,25,34,29,4855,7.3,3174000,20551722662,355,2590205,0,"범죄,액션",씨제이이앤엠(주),남자,남자,남자,0
634,아수라,2016-09-28,2016-10-24,26,53,38,6994,4.9,2474500,20554197162,342,2590547,0,"범죄,액션",씨제이이앤엠(주),남자,남자,남자,0
635,아수라,2016-09-28,2016-10-25,27,40,29,5423,5.6,2306500,20556503662,302,2590849,0,"범죄,액션",씨제이이앤엠(주),남자,남자,남자,0
636,아수라,2016-09-28,2016-10-26,28,25,24,3397,19.7,3860500,20560364162,670,2591519,0,"범죄,액션",씨제이이앤엠(주),남자,남자,남자,0
637,아수라,2016-09-28,2016-10-27,29,24,24,3468,18.1,3632500,20563996662,628,2592147,0,"범죄,액션",씨제이이앤엠(주),남자,남자,남자,0
638,아수라,2016-09-28,2016-10-28,30,6,6,1254,12.5,878000,20564874662,157,2592304,0,"범죄,액션",씨제이이앤엠(주),남자,남자,남자,0
639,아수라,2016-09-28,2016-10-29,31,5,5,972,12.9,750000,20565624662,125,2592429,0,"범죄,액션",씨제이이앤엠(주),남자,남자,남자,0
640,아수라,2016-09-28,2016-10-30,32,5,5,1146,10.9,750000,20566374662,125,2592554,0,"범죄,액션",씨제이이앤엠(주),남자,남자,남자,0
641,아수라,2016-09-28,2016-10-31,33,2,2,354,4.2,79000,20566453662,15,2592569,0,"범죄,액션",씨제이이앤엠(주),남자,남자,남자,0
642,아수라,2016-09-28,2016-11-01,34,6,6,985,13.4,806000,20567259662,132,2592701,0,"범죄,액션",씨제이이앤엠(주),남자,남자,남자,0
643,아수라,2016-09-28,2016-11-02,35,6,6,985,13.5,817000,20568076662,133,2592834,0,"범죄,액션",씨제이이앤엠(주),남자,남자,남자,0
644,아수라,2016-09-28,2016-11-03,36,5,5,813,15.4,750000,20568826662,125,2592959,0,"범죄,액션",씨제이이앤엠(주),남자,남자,남자,0
645,아수라,2016-09-28,2016-11-04,37,5,5,813,15.4,750000,20569576662,125,2593084,0,"범죄,액션",씨제이이앤엠(주),남자,남자,남자,0
646,아수라,2016-09-28,2016-11-05,38,5,5,937,13.3,750000,20570326662,125,2593209,0,"범죄,액션",씨제이이앤엠(주),남자,남자,남자,0
647,아수라,2016-09-28,2016-11-06,39,4,4,743,13.5,600000,20570926662,100,2593309,0,"범죄,액션",씨제이이앤엠(주),남자,남자,남자,0
648,아수라,2016-09-28,2016-11-07,40,5,5,967,12.9,750000,20571676662,125,2593434,0,"범죄,액션",씨제이이앤엠(주),남자,남자,남자,0
649,아수라,2016-09-28,2016-11-08,41,5,5,967,12.9,750000,20572426662,125,2593559,0,"범죄,액션",씨제이이앤엠(주),남자,남자,남자,0
650,아수라,2016-09-28,2016-11-20,53,1,1,161,100.0,1644000,20574070662,161,2593720,0,"범죄,액션",씨제이이앤엠(주),남자,남자,남자,0
651,아수라,2016-09-28,2016-12-02,65,2,2,436,70.6,2156000,20576226662,308,2594028,0,"범죄,액션",씨제이이앤엠(주),남자,남자,남자,0
652,아수라,2016-09-28,2017-03-03,156,1,1,76,100.0,380000,20576606662,76,2594104,0,"범죄,액션",씨제이이앤엠(주),남자,남자,남자,0
653,아수라,2016-09-28,2017-04-23,207,1,1,82,30.5,200000,20576806662,25,2594129,0,"범죄,액션",씨제이이앤엠(주),남자,남자,남자,0
654,아수라,2016-09-28,2017-09-29,366,2,1,388,75.0,2910000,20579716662,291,2594420,0,"범죄,액션",씨제이이앤엠(주),남자,남자,남자,0
655,아수라,2016-09-28,2018-09-29,731,1,1,80,100.0,880000,20580596662,80,2594500,0,"범죄,액션",씨제이이앤엠(주),남자,남자,남자,0
656,아수라,2016-09-28,2018-10-10,742,2,1,228,4.4,50000,20580646662,10,2594510,0,"범죄,액션",씨제이이앤엠(주),남자,남자,남자,0
657,아수라,2016-09-28,2018-10-11,743,2,1,228,4.8,55000,20580701662,11,2594521,0,"범죄,액션",씨제이이앤엠(주),남자,남자,남자,0
658,아수라,2016-09-28,2018-10-12,744,1,1,70,2.9,10000,20580711662,2,2594523,0,"범죄,액션",씨제이이앤엠(주),남자,남자,남자,0
659,아수라,2016-09-28,2018-10-13,745,2,1,228,3.1,35000,20580746662,7,2594530,0,"범죄,액션",씨제이이앤엠(주),남자,남자,남자,0
660,아수라,2016-09-28,2018-10-14,746,2,1,228,2.2,25000,20580771662,5,2594535,0,"범죄,액션",씨제이이앤엠(주),남자,남자,남자,0
661,아수라,2016-09-28,2018-10-15,747,1,1,70,1.4,5000,20580776662,1,2594536,0,"범죄,액션",씨제이이앤엠(주),남자,남자,남자,0
662,아수라,2016-09-28,2018-10-16,748,1,1,114,4.4,25000,20580801662,5,2594541,0,"범죄,액션",씨제이이앤엠(주),남자,남자,남자,0
663,아수라,2016-09-28,2018-10-17,749,2,1,228,1.8,20000,20580821662,4,2594545,0,"범죄,액션",씨제이이앤엠(주),남자,남자,남자,0
664,아수라,2016-09-28,2019-06-08,983,1,1,8,100.0,96000,20580917662,8,2594553,0,"범죄,액션",씨제이이앤엠(주),남자,남자,남자,0
665,아수라,2016-09-28,2019-09-28,1095,1,1,142,100.0,1562000,20582479662,142,2594695,0,"범죄,액션",씨제이이앤엠(주),남자,남자,남자,0
666,형,2016-11-23,2016-11-10,-13,1,1,326,100.0,1956000,1956000,326,326,1,"코미디,드라마",씨제이이앤엠(주),남자,여자,남자,1
667,형,2016-11-23,2016-11-11,-12,9,9,2479,100.0,21580000,23536000,2479,2805,1,"코미디,드라마",씨제이이앤엠(주),남자,여자,남자,1
668,형,2016-11-23,2016-11-15,-8,8,7,1710,94.2,11764000,35300000,1610,4415,1,"코미디,드라마",씨제이이앤엠(주),남자,여자,남자,1
669,형,2016-11-23,2016-11-16,-7,48,46,10673,99.9,77446000,112746000,10665,15080,1,"코미디,드라마",씨제이이앤엠(주),남자,여자,남자,1
670,형,2016-11-23,2016-11-17,-6,1,1,218,2.3,45000,112791000,5,15085,1,"코미디,드라마",씨제이이앤엠(주),남자,여자,남자,1
671,형,2016-11-23,2016-11-18,-5,4,4,1098,79.3,8290000,121081000,871,15956,1,"코미디,드라마",씨제이이앤엠(주),남자,여자,남자,1
672,형,2016-11-23,2016-11-19,-4,12,10,3114,79.3,23445000,144526000,2468,18424,1,"코미디,드라마",씨제이이앤엠(주),남자,여자,남자,1
673,형,2016-11-23,2016-11-20,-3,16,14,2730,76.6,18849000,163375000,2091,20515,1,"코미디,드라마",씨제이이앤엠(주),남자,여자,남자,1
674,형,2016-11-23,2016-11-23,0,2150,744,355704,21.3,574152500,737527500,75882,96397,1,"코미디,드라마",씨제이이앤엠(주),남자,여자,남자,1
675,형,2016-11-23,2016-11-24,1,4672,933,811474,16.9,1009937600,1747465100,136871,233268,1,"코미디,드라마",씨제이이앤엠(주),남자,여자,남자,1
676,형,2016-11-23,2016-11-25,2,4869,922,846341,19.4,1309855652,3057320752,164294,397562,1,"코미디,드라마",씨제이이앤엠(주),남자,여자,남자,1
677,형,2016-11-23,2016-11-26,3,5390,985,951283,33.5,2621334962,5678655714,318215,715777,1,"코미디,드라마",씨제이이앤엠(주),남자,여자,남자,1
678,형,2016-11-23,2016-11-27,4,5254,993,928258,34.7,2659765800,8338421514,322030,1037807,1,"코미디,드라마",씨제이이앤엠(주),남자,여자,남자,1
679,형,2016-11-23,2016-11-28,5,4916,917,845867,14.7,911932500,9250354014,124258,1162065,1,"코미디,드라마",씨제이이앤엠(주),남자,여자,남자,1
680,형,2016-11-23,2016-11-29,6,4936,945,844073,14.7,897445500,10147799514,123744,1285809,1,"코미디,드라마",씨제이이앤엠(주),남자,여자,남자,1
681,형,2016-11-23,2016-11-30,7,3415,772,620359,28.3,1021237700,11169037214,175672,1461481,1,"코미디,드라마",씨제이이앤엠(주),남자,여자,남자,1
682,형,2016-11-23,2016-12-01,8,3485,788,627846,16.0,726691800,11895729014,100341,1561822,1,"코미디,드라마",씨제이이앤엠(주),남자,여자,남자,1
683,형,2016-11-23,2016-12-02,9,3697,806,667293,18.6,985841547,12881570561,123789,1685611,1,"코미디,드라마",씨제이이앤엠(주),남자,여자,남자,1
684,형,2016-11-23,2016-12-03,10,4129,821,763898,31.9,2025459932,14907030493,243855,1929466,1,"코미디,드라마",씨제이이앤엠(주),남자,여자,남자,1
685,형,2016-11-23,2016-12-04,11,4071,832,755451,30.5,1943331900,16850362393,230616,2160082,1,"코미디,드라마",씨제이이앤엠(주),남자,여자,남자,1
686,형,2016-11-23,2016-12-05,12,3792,781,690658,11.7,593668700,17444031093,80495,2240577,1,"코미디,드라마",씨제이이앤엠(주),남자,여자,남자,1
687,형,2016-11-23,2016-12-06,13,3762,797,683913,11.8,582149500,18026180593,80621,2321198,1,"코미디,드라마",씨제이이앤엠(주),남자,여자,남자,1
688,형,2016-11-23,2016-12-07,14,2189,573,325118,15.8,373045600,18399226193,51238,2372436,1,"코미디,드라마",씨제이이앤엠(주),남자,여자,남자,1
689,형,2016-11-23,2016-12-08,15,2068,563,310415,15.7,348752000,18747978193,48741,2421177,1,"코미디,드라마",씨제이이앤엠(주),남자,여자,남자,1
690,형,2016-11-23,2016-12-09,16,2156,553,324670,18.0,466072000,19214050193,58264,2479441,1,"코미디,드라마",씨제이이앤엠(주),남자,여자,남자,1
691,형,2016-11-23,2016-12-10,17,2288,603,341729,32.4,904870500,20118920693,110537,2589978,1,"코미디,드라마",씨제이이앤엠(주),남자,여자,남자,1
692,형,2016-11-23,2016-12-11,18,2194,593,327469,29.2,789946400,20908867093,95521,2685499,1,"코미디,드라마",씨제이이앤엠(주),남자,여자,남자,1
693,형,2016-11-23,2016-12-12,19,2103,540,312817,10.2,230779400,21139646493,31916,2717415,1,"코미디,드라마",씨제이이앤엠(주),남자,여자,남자,1
694,형,2016-11-23,2016-12-13,20,2117,581,312708,12.1,265728600,21405375093,37741,2755156,1,"코미디,드라마",씨제이이앤엠(주),남자,여자,남자,1
695,형,2016-11-23,2016-12-14,21,1397,497,189349,13.9,187463900,21592838993,26365,2781521,1,"코미디,드라마",씨제이이앤엠(주),남자,여자,남자,1
696,형,2016-11-23,2016-12-15,22,1312,464,178919,14.6,183635200,21776474193,26085,2807606,1,"코미디,드라마",씨제이이앤엠(주),남자,여자,남자,1
697,형,2016-11-23,2016-12-16,23,1326,475,179804,16.3,228595300,22005069493,29342,2836948,1,"코미디,드라마",씨제이이앤엠(주),남자,여자,남자,1
698,형,2016-11-23,2016-12-17,24,1214,460,161440,29.8,385648500,22390717993,48118,2885066,1,"코미디,드라마",씨제이이앤엠(주),남자,여자,남자,1
699,형,2016-11-23,2016-12-18,25,1173,453,154821,28.6,360053800,22750771793,44239,2929305,1,"코미디,드라마",씨제이이앤엠(주),남자,여자,남자,1
700,형,2016-11-23,2016-12-19,26,1239,443,167546,9.9,121860600,22872632393,16508,2945813,1,"코미디,드라마",씨제이이앤엠(주),남자,여자,남자,1
701,형,2016-11-23,2016-12-20,27,1210,449,163219,10.4,119736700,22992369093,16915,2962728,1,"코미디,드라마",씨제이이앤엠(주),남자,여자,남자,1
702,형,2016-11-23,2016-12-21,28,175,117,23081,11.3,17343000,23009712093,2599,2965327,1,"코미디,드라마",씨제이이앤엠(주),남자,여자,남자,1
703,형,2016-11-23,2016-12-22,29,149,107,21008,12.8,18280400,23027992493,2681,2968008,1,"코미디,드라마",씨제이이앤엠(주),남자,여자,남자,1
704,형,2016-11-23,2016-12-23,30,139,98,20593,12.5,19423000,23047415493,2575,2970583,1,"코미디,드라마",씨제이이앤엠(주),남자,여자,남자,1
705,형,2016-11-23,2016-12-24,31,79,64,11458,21.2,18947500,23066362993,2431,2973014,1,"코미디,드라마",씨제이이앤엠(주),남자,여자,남자,1
706,형,2016-11-23,2016-12-25,32,72,58,12250,21.1,20470900,23086833893,2588,2975602,1,"코미디,드라마",씨제이이앤엠(주),남자,여자,남자,1
707,형,2016-11-23,2016-12-26,33,117,80,17023,7.7,8534500,23095368393,1306,2976908,1,"코미디,드라마",씨제이이앤엠(주),남자,여자,남자,1
708,형,2016-11-23,2016-12-27,34,107,74,15470,9.4,10460900,23105829293,1459,2978367,1,"코미디,드라마",씨제이이앤엠(주),남자,여자,남자,1
709,형,2016-11-23,2016-12-28,35,15,12,2209,13.4,1783500,23107612793,295,2978662,1,"코미디,드라마",씨제이이앤엠(주),남자,여자,남자,1
710,형,2016-11-23,2016-12-29,36,15,13,2344,10.9,1552000,23109164793,255,2978917,1,"코미디,드라마",씨제이이앤엠(주),남자,여자,남자,1
711,형,2016-11-23,2016-12-30,37,15,12,2285,23.4,3032500,23112197293,534,2979451,1,"코미디,드라마",씨제이이앤엠(주),남자,여자,남자,1
712,형,2016-11-23,2016-12-31,38,12,10,1937,10.7,1571000,23113768293,208,2979659,1,"코미디,드라마",씨제이이앤엠(주),남자,여자,남자,1
713,형,2016-11-23,2017-01-01,39,9,8,1378,8.9,944000,23114712293,123,2979782,1,"코미디,드라마",씨제이이앤엠(주),남자,여자,남자,1
714,형,2016-11-23,2017-01-02,40,14,11,2079,15.5,2429900,23117142193,323,2980105,1,"코미디,드라마",씨제이이앤엠(주),남자,여자,남자,1
715,형,2016-11-23,2017-01-03,41,15,12,3093,5.2,1082000,23118224193,162,2980267,1,"코미디,드라마",씨제이이앤엠(주),남자,여자,남자,1
716,형,2016-11-23,2017-01-04,42,2,2,431,7.4,190000,23118414193,32,2980299,1,"코미디,드라마",씨제이이앤엠(주),남자,여자,남자,1
717,형,2016-11-23,2017-01-05,43,1,1,304,5.3,86000,23118500193,16,2980315,1,"코미디,드라마",씨제이이앤엠(주),남자,여자,남자,1
718,형,2016-11-23,2017-01-06,44,1,1,304,6.9,136000,23118636193,21,2980336,1,"코미디,드라마",씨제이이앤엠(주),남자,여자,남자,1
719,형,2016-11-23,2017-01-07,45,2,1,266,12.4,242500,23118878693,33,2980369,1,"코미디,드라마",씨제이이앤엠(주),남자,여자,남자,1
720,형,2016-11-23,2017-01-08,46,2,1,266,10.5,188500,23119067193,28,2980397,1,"코미디,드라마",씨제이이앤엠(주),남자,여자,남자,1
721,형,2016-11-23,2017-01-09,47,1,1,133,25.6,177000,23119244193,34,2980431,1,"코미디,드라마",씨제이이앤엠(주),남자,여자,남자,1
722,형,2016-11-23,2017-01-10,48,3,2,570,34.9,1168000,23120412193,199,2980630,1,"코미디,드라마",씨제이이앤엠(주),남자,여자,남자,1
723,형,2016-11-23,2017-01-11,49,2,1,608,13.7,491000,23120903193,83,2980713,1,"코미디,드라마",씨제이이앤엠(주),남자,여자,남자,1
724,형,2016-11-23,2017-01-12,50,5,3,1226,87.8,6922200,23127825393,1076,2981789,1,"코미디,드라마",씨제이이앤엠(주),남자,여자,남자,1
725,형,2016-11-23,2017-01-16,54,1,1,133,15.0,109000,23127934393,20,2981809,1,"코미디,드라마",씨제이이앤엠(주),남자,여자,남자,1
726,형,2016-11-23,2017-01-17,55,1,1,108,34.3,202000,23128136393,37,2981846,1,"코미디,드라마",씨제이이앤엠(주),남자,여자,남자,1
727,형,2016-11-23,2017-01-18,56,1,1,205,10.2,113000,23128249393,21,2981867,1,"코미디,드라마",씨제이이앤엠(주),남자,여자,남자,1
728,형,2016-11-23,2017-01-19,57,1,1,127,24.4,182500,23128431893,31,2981898,1,"코미디,드라마",씨제이이앤엠(주),남자,여자,남자,1
729,형,2016-11-23,2017-01-20,58,1,1,205,3.9,44000,23128475893,8,2981906,1,"코미디,드라마",씨제이이앤엠(주),남자,여자,남자,1
730,형,2016-11-23,2017-01-21,59,1,1,127,7.1,59500,23128535393,9,2981915,1,"코미디,드라마",씨제이이앤엠(주),남자,여자,남자,1
731,형,2016-11-23,2017-01-22,60,2,2,241,7.9,122000,23128657393,19,2981934,1,"코미디,드라마",씨제이이앤엠(주),남자,여자,남자,1
732,형,2016-11-23,2017-01-23,61,2,1,266,7.5,109000,23128766393,20,2981954,1,"코미디,드라마",씨제이이앤엠(주),남자,여자,남자,1
733,형,2016-11-23,2017-01-24,62,2,1,266,25.6,345500,23129111893,68,2982022,1,"코미디,드라마",씨제이이앤엠(주),남자,여자,남자,1
734,형,2016-11-23,2017-03-23,120,1,1,132,90.9,500000,23129611893,120,2982142,1,"코미디,드라마",씨제이이앤엠(주),남자,여자,남자,1
735,형,2016-11-23,2017-11-13,355,1,1,85,0.0,0,23129611893,0,2982142,1,"코미디,드라마",씨제이이앤엠(주),남자,여자,남자,1
736,형,2016-11-23,2017-11-20,362,1,1,85,0.0,0,23129611893,0,2982142,1,"코미디,드라마",씨제이이앤엠(주),남자,여자,남자,1
737,형,2016-11-23,2017-11-28,370,1,1,134,65.7,577000,23130188893,88,2982230,1,"코미디,드라마",씨제이이앤엠(주),남자,여자,남자,1
738,형,2016-11-23,2018-10-20,696,2,2,292,7.5,170000,23130358893,22,2982252,1,"코미디,드라마",씨제이이앤엠(주),남자,여자,남자,1
739,형,2016-11-23,2018-10-22,698,1,1,100,8.0,51800,23130410693,8,2982260,1,"코미디,드라마",씨제이이앤엠(주),남자,여자,남자,1
740,형,2016-11-23,2018-10-23,699,1,1,172,5.2,63000,23130473693,9,2982269,1,"코미디,드라마",씨제이이앤엠(주),남자,여자,남자,1
741,형,2016-11-23,2018-10-26,702,1,1,172,23.8,328000,23130801693,41,2982310,1,"코미디,드라마",씨제이이앤엠(주),남자,여자,남자,1
742,형,2016-11-23,2018-10-27,703,1,1,100,1.0,5000,23130806693,1,2982311,1,"코미디,드라마",씨제이이앤엠(주),남자,여자,남자,1
743,형,2016-11-23,2018-10-28,704,1,1,126,7.1,72000,23130878693,9,2982320,1,"코미디,드라마",씨제이이앤엠(주),남자,여자,남자,1
744,형,2016-11-23,2019-09-21,1032,1,1,194,100.0,2328000,23133206693,194,2982514,1,"코미디,드라마",씨제이이앤엠(주),남자,여자,남자,1
745,판도라,2016-12-07,2016-11-15,-22,3,1,1203,100.0,9624000,9624000,1203,1203,0,"드라마,스릴러",(주)넥스트엔터테인먼트월드(NEW),남자,남자,남자,0
746,판도라,2016-12-07,2016-11-22,-15,3,3,766,100.0,6128000,15752000,766,1969,0,"드라마,스릴러",(주)넥스트엔터테인먼트월드(NEW),남자,남자,남자,0
747,판도라,2016-12-07,2016-11-24,-13,2,2,474,94.7,2940000,18692000,449,2418,0,"드라마,스릴러",(주)넥스트엔터테인먼트월드(NEW),남자,남자,남자,0
748,판도라,2016-12-07,2016-11-29,-8,28,28,6042,99.7,48192000,66884000,6024,8442,0,"드라마,스릴러",(주)넥스트엔터테인먼트월드(NEW),남자,남자,남자,0
749,판도라,2016-12-07,2016-11-30,-7,15,15,4315,94.1,31844000,98728000,4061,12503,0,"드라마,스릴러",(주)넥스트엔터테인먼트월드(NEW),남자,남자,남자,0
750,판도라,2016-12-07,2016-12-01,-6,2,2,506,100.0,4048000,102776000,506,13009,0,"드라마,스릴러",(주)넥스트엔터테인먼트월드(NEW),남자,남자,남자,0
751,판도라,2016-12-07,2016-12-02,-5,20,20,4400,99.8,43087000,145863000,4392,17401,0,"드라마,스릴러",(주)넥스트엔터테인먼트월드(NEW),남자,남자,남자,0
752,판도라,2016-12-07,2016-12-04,-3,1,1,134,100.0,1340000,147203000,134,17535,0,"드라마,스릴러",(주)넥스트엔터테인먼트월드(NEW),남자,남자,남자,0
753,판도라,2016-12-07,2016-12-06,-1,4,4,908,92.2,6652000,153855000,837,18372,0,"드라마,스릴러",(주)넥스트엔터테인먼트월드(NEW),남자,남자,남자,0
754,판도라,2016-12-07,2016-12-07,0,4777,1029,918214,16.8,1138891200,1292746200,154652,173024,0,"드라마,스릴러",(주)넥스트엔터테인먼트월드(NEW),남자,남자,남자,0
755,판도라,2016-12-07,2016-12-08,1,4741,1074,904435,18.2,1206239000,2498985200,164931,337955,0,"드라마,스릴러",(주)넥스트엔터테인먼트월드(NEW),남자,남자,남자,0
756,판도라,2016-12-07,2016-12-09,2,4919,1086,942625,22.3,1694603296,4193588496,210438,548393,0,"드라마,스릴러",(주)넥스트엔터테인먼트월드(NEW),남자,남자,남자,0
757,판도라,2016-12-07,2016-12-10,3,5448,1166,1050486,42.6,3734861514,7928450010,447707,996100,0,"드라마,스릴러",(주)넥스트엔터테인먼트월드(NEW),남자,남자,남자,0
758,판도라,2016-12-07,2016-12-11,4,5324,1160,1030036,45.0,3870900800,11799350810,463151,1459251,0,"드라마,스릴러",(주)넥스트엔터테인먼트월드(NEW),남자,남자,남자,0
759,판도라,2016-12-07,2016-12-12,5,4956,1085,953707,16.8,1179889900,12979240710,160345,1619596,0,"드라마,스릴러",(주)넥스트엔터테인먼트월드(NEW),남자,남자,남자,0
760,판도라,2016-12-07,2016-12-13,6,4982,1117,953332,17.4,1211396000,14190636710,165775,1785371,0,"드라마,스릴러",(주)넥스트엔터테인먼트월드(NEW),남자,남자,남자,0
761,판도라,2016-12-07,2016-12-14,7,4584,1080,885081,18.3,1173549200,15364185910,162153,1947524,0,"드라마,스릴러",(주)넥스트엔터테인먼트월드(NEW),남자,남자,남자,0
762,판도라,2016-12-07,2016-12-15,8,4590,1083,883389,18.1,1160974100,16525160010,159809,2107333,0,"드라마,스릴러",(주)넥스트엔터테인먼트월드(NEW),남자,남자,남자,0
763,판도라,2016-12-07,2016-12-16,9,4825,1115,927134,22.7,1670473585,18195633595,210230,2317563,0,"드라마,스릴러",(주)넥스트엔터테인먼트월드(NEW),남자,남자,남자,0
764,판도라,2016-12-07,2016-12-17,10,5354,1184,1034763,38.8,3322781267,21518414862,401518,2719081,0,"드라마,스릴러",(주)넥스트엔터테인먼트월드(NEW),남자,남자,남자,0
765,판도라,2016-12-07,2016-12-18,11,5224,1153,1009985,39.1,3283355300,24801770162,394567,3113648,0,"드라마,스릴러",(주)넥스트엔터테인먼트월드(NEW),남자,남자,남자,0
766,판도라,2016-12-07,2016-12-19,12,4857,1096,939054,14.2,985648800,25787418962,133106,3246754,0,"드라마,스릴러",(주)넥스트엔터테인먼트월드(NEW),남자,남자,남자,0
767,판도라,2016-12-07,2016-12-20,13,4857,1134,932339,14.5,979907000,26767325962,135019,3381773,0,"드라마,스릴러",(주)넥스트엔터테인먼트월드(NEW),남자,남자,남자,0
768,판도라,2016-12-07,2016-12-21,14,2346,705,344389,18.0,446356000,27213681962,62014,3443787,0,"드라마,스릴러",(주)넥스트엔터테인먼트월드(NEW),남자,남자,남자,0
769,판도라,2016-12-07,2016-12-22,15,2328,704,340043,18.5,454805100,27668487062,62801,3506588,0,"드라마,스릴러",(주)넥스트엔터테인먼트월드(NEW),남자,남자,남자,0
770,판도라,2016-12-07,2016-12-23,16,2330,701,344265,22.7,623073379,28291560441,78269,3584857,0,"드라마,스릴러",(주)넥스트엔터테인먼트월드(NEW),남자,남자,남자,0
771,판도라,2016-12-07,2016-12-24,17,2108,654,298230,59.7,1458537223,29750097664,177961,3762818,0,"드라마,스릴러",(주)넥스트엔터테인먼트월드(NEW),남자,남자,남자,0
772,판도라,2016-12-07,2016-12-25,18,2030,655,284569,60.8,1411422700,31161520364,173095,3935913,0,"드라마,스릴러",(주)넥스트엔터테인먼트월드(NEW),남자,남자,남자,0
773,판도라,2016-12-07,2016-12-26,19,2159,663,307718,18.1,407037500,31568557864,55796,3991709,0,"드라마,스릴러",(주)넥스트엔터테인먼트월드(NEW),남자,남자,남자,0
774,판도라,2016-12-07,2016-12-27,20,2172,668,311074,17.8,397729800,31966287664,55262,4046971,0,"드라마,스릴러",(주)넥스트엔터테인먼트월드(NEW),남자,남자,남자,0
775,판도라,2016-12-07,2016-12-28,21,1416,551,190294,31.5,353210500,32319498164,59865,4106836,0,"드라마,스릴러",(주)넥스트엔터테인먼트월드(NEW),남자,남자,남자,0
776,판도라,2016-12-07,2016-12-29,22,1383,519,181179,25.9,341160200,32660658364,46957,4153793,0,"드라마,스릴러",(주)넥스트엔터테인먼트월드(NEW),남자,남자,남자,0
777,판도라,2016-12-07,2016-12-30,23,1465,535,191670,34.1,522508800,33183167164,65306,4219099,0,"드라마,스릴러",(주)넥스트엔터테인먼트월드(NEW),남자,남자,남자,0
778,판도라,2016-12-07,2016-12-31,24,1505,566,198075,47.8,772231000,33955398164,94765,4313864,0,"드라마,스릴러",(주)넥스트엔터테인먼트월드(NEW),남자,남자,남자,0
779,판도라,2016-12-07,2017-01-01,25,1476,576,195344,45.0,736891900,34692290064,87966,4401830,0,"드라마,스릴러",(주)넥스트엔터테인먼트월드(NEW),남자,남자,남자,0
780,판도라,2016-12-07,2017-01-02,26,1495,540,197888,19.2,283473300,34975763364,38072,4439902,0,"드라마,스릴러",(주)넥스트엔터테인먼트월드(NEW),남자,남자,남자,0
781,판도라,2016-12-07,2017-01-03,27,1463,538,192788,14.3,205442000,35181205364,27605,4467507,0,"드라마,스릴러",(주)넥스트엔터테인먼트월드(NEW),남자,남자,남자,0
782,판도라,2016-12-07,2017-01-04,28,685,335,94290,13.4,92821100,35274026464,12620,4480127,0,"드라마,스릴러",(주)넥스트엔터테인먼트월드(NEW),남자,남자,남자,0
783,판도라,2016-12-07,2017-01-05,29,642,322,90054,12.8,84874600,35358901064,11481,4491608,0,"드라마,스릴러",(주)넥스트엔터테인먼트월드(NEW),남자,남자,남자,0
784,판도라,2016-12-07,2017-01-06,30,598,310,82216,13.9,94003800,35452904864,11450,4503058,0,"드라마,스릴러",(주)넥스트엔터테인먼트월드(NEW),남자,남자,남자,0
785,판도라,2016-12-07,2017-01-07,31,555,304,74981,28.9,177307500,35630212364,21657,4524715,0,"드라마,스릴러",(주)넥스트엔터테인먼트월드(NEW),남자,남자,남자,0
786,판도라,2016-12-07,2017-01-08,32,539,297,72432,29.0,172051100,35802263464,20971,4545686,0,"드라마,스릴러",(주)넥스트엔터테인먼트월드(NEW),남자,남자,남자,0
787,판도라,2016-12-07,2017-01-09,33,539,295,72437,9.2,49099800,35851363264,6682,4552368,0,"드라마,스릴러",(주)넥스트엔터테인먼트월드(NEW),남자,남자,남자,0
788,판도라,2016-12-07,2017-01-10,34,533,294,70313,9.8,50113000,35901476264,6870,4559238,0,"드라마,스릴러",(주)넥스트엔터테인먼트월드(NEW),남자,남자,남자,0
789,판도라,2016-12-07,2017-01-11,35,195,107,26221,12.3,22329300,35923805564,3228,4562466,0,"드라마,스릴러",(주)넥스트엔터테인먼트월드(NEW),남자,남자,남자,0
790,판도라,2016-12-07,2017-01-12,36,104,62,12530,14.0,12348200,35936153764,1754,4564220,0,"드라마,스릴러",(주)넥스트엔터테인먼트월드(NEW),남자,남자,남자,0
791,판도라,2016-12-07,2017-01-13,37,97,58,12417,17.7,15006000,35951159764,2191,4566411,0,"드라마,스릴러",(주)넥스트엔터테인먼트월드(NEW),남자,남자,남자,0
792,판도라,2016-12-07,2017-01-14,38,101,63,13041,29.1,27891200,35979050964,3793,4570204,0,"드라마,스릴러",(주)넥스트엔터테인먼트월드(NEW),남자,남자,남자,0
793,판도라,2016-12-07,2017-01-15,39,103,66,13368,29.8,29404100,36008455064,3988,4574192,0,"드라마,스릴러",(주)넥스트엔터테인먼트월드(NEW),남자,남자,남자,0
794,판도라,2016-12-07,2017-01-16,40,100,59,11679,11.8,9108200,36017563264,1382,4575574,0,"드라마,스릴러",(주)넥스트엔터테인먼트월드(NEW),남자,남자,남자,0
795,판도라,2016-12-07,2017-01-17,41,95,59,10751,14.6,9923800,36027487064,1564,4577138,0,"드라마,스릴러",(주)넥스트엔터테인먼트월드(NEW),남자,남자,남자,0
796,판도라,2016-12-07,2017-01-18,42,20,14,2153,23.4,3050000,36030537064,504,4577642,0,"드라마,스릴러",(주)넥스트엔터테인먼트월드(NEW),남자,남자,남자,0
797,판도라,2016-12-07,2017-01-19,43,24,20,2591,25.7,3983000,36034520064,667,4578309,0,"드라마,스릴러",(주)넥스트엔터테인먼트월드(NEW),남자,남자,남자,0
798,판도라,2016-12-07,2017-01-20,44,23,19,2415,17.6,2724000,36037244064,424,4578733,0,"드라마,스릴러",(주)넥스트엔터테인먼트월드(NEW),남자,남자,남자,0
799,판도라,2016-12-07,2017-01-21,45,20,17,2140,17.8,2186000,36039430064,380,4579113,0,"드라마,스릴러",(주)넥스트엔터테인먼트월드(NEW),남자,남자,남자,0
800,판도라,2016-12-07,2017-01-22,46,20,18,2215,21.3,2772500,36042202564,471,4579584,0,"드라마,스릴러",(주)넥스트엔터테인먼트월드(NEW),남자,남자,남자,0
801,판도라,2016-12-07,2017-01-23,47,18,14,1796,9.8,905000,36043107564,176,4579760,0,"드라마,스릴러",(주)넥스트엔터테인먼트월드(NEW),남자,남자,남자,0
802,판도라,2016-12-07,2017-01-24,48,22,16,2782,37.8,5689000,36048796564,1051,4580811,0,"드라마,스릴러",(주)넥스트엔터테인먼트월드(NEW),남자,남자,남자,0
803,판도라,2016-12-07,2017-01-25,49,7,7,1270,71.8,5315000,36054111564,912,4581723,0,"드라마,스릴러",(주)넥스트엔터테인먼트월드(NEW),남자,남자,남자,0
804,판도라,2016-12-07,2017-01-26,50,2,2,241,43.2,420000,36054531564,104,4581827,0,"드라마,스릴러",(주)넥스트엔터테인먼트월드(NEW),남자,남자,남자,0
805,판도라,2016-12-07,2017-01-27,51,3,3,400,69.8,1199500,36055731064,279,4582106,0,"드라마,스릴러",(주)넥스트엔터테인먼트월드(NEW),남자,남자,남자,0
806,판도라,2016-12-07,2017-01-28,52,4,4,475,61.1,1292000,36057023064,290,4582396,0,"드라마,스릴러",(주)넥스트엔터테인먼트월드(NEW),남자,남자,남자,0
807,판도라,2016-12-07,2017-01-29,53,2,2,304,78.3,990000,36058013064,238,4582634,0,"드라마,스릴러",(주)넥스트엔터테인먼트월드(NEW),남자,남자,남자,0
808,판도라,2016-12-07,2017-01-30,54,2,2,304,79.0,1000000,36059013064,240,4582874,0,"드라마,스릴러",(주)넥스트엔터테인먼트월드(NEW),남자,남자,남자,0
809,판도라,2016-12-07,2017-01-31,55,1,1,151,66.2,400000,36059413064,100,4582974,0,"드라마,스릴러",(주)넥스트엔터테인먼트월드(NEW),남자,남자,남자,0
810,판도라,2016-12-07,2017-02-03,58,1,1,224,78.1,1300000,36060713064,175,4583149,0,"드라마,스릴러",(주)넥스트엔터테인먼트월드(NEW),남자,남자,남자,0
811,판도라,2016-12-07,2017-02-21,76,1,1,130,0.0,0,36060713064,0,4583149,0,"드라마,스릴러",(주)넥스트엔터테인먼트월드(NEW),남자,남자,남자,0
812,판도라,2016-12-07,2017-02-22,77,1,1,121,100.0,605000,36061318064,121,4583270,0,"드라마,스릴러",(주)넥스트엔터테인먼트월드(NEW),남자,남자,남자,0
813,판도라,2016-12-07,2017-03-09,92,1,1,145,79.3,803000,36062121064,115,4583385,0,"드라마,스릴러",(주)넥스트엔터테인먼트월드(NEW),남자,남자,남자,0
814,판도라,2016-12-07,2017-03-11,94,1,1,260,100.0,2340000,36064461064,260,4583645,0,"드라마,스릴러",(주)넥스트엔터테인먼트월드(NEW),남자,남자,남자,0
815,판도라,2016-12-07,2017-04-25,139,1,1,82,30.5,150000,36064611064,25,4583670,0,"드라마,스릴러",(주)넥스트엔터테인먼트월드(NEW),남자,남자,남자,0
816,판도라,2016-12-07,2017-05-18,162,1,1,332,0.0,0,36064611064,0,4583670,0,"드라마,스릴러",(주)넥스트엔터테인먼트월드(NEW),남자,남자,남자,0
817,판도라,2016-12-07,2017-06-20,195,1,1,151,99.3,600000,36065211064,150,4583820,0,"드라마,스릴러",(주)넥스트엔터테인먼트월드(NEW),남자,남자,남자,0
818,판도라,2016-12-07,2017-11-14,342,4,1,1200,30.8,738000,36065949064,369,4584189,0,"드라마,스릴러",(주)넥스트엔터테인먼트월드(NEW),남자,남자,남자,0
819,판도라,2016-12-07,2017-11-15,343,4,1,1200,18.1,434000,36066383064,217,4584406,0,"드라마,스릴러",(주)넥스트엔터테인먼트월드(NEW),남자,남자,남자,0
820,판도라,2016-12-07,2017-11-16,344,4,1,1200,17.1,410000,36066793064,205,4584611,0,"드라마,스릴러",(주)넥스트엔터테인먼트월드(NEW),남자,남자,남자,0
821,판도라,2016-12-07,2017-11-17,345,4,1,1200,15.8,378000,36067171064,189,4584800,0,"드라마,스릴러",(주)넥스트엔터테인먼트월드(NEW),남자,남자,남자,0
822,판도라,2016-12-07,2018-11-13,706,1,1,164,56.7,465000,36067636064,93,4584893,0,"드라마,스릴러",(주)넥스트엔터테인먼트월드(NEW),남자,남자,남자,0
823,판도라,2016-12-07,2019-06-24,929,1,1,100,100.0,700000,36068336064,100,4584993,0,"드라마,스릴러",(주)넥스트엔터테인먼트월드(NEW),남자,남자,남자,0
824,판도라,2016-12-07,2019-09-20,1017,1,1,114,107.9,861000,36069197064,123,4585116,0,"드라마,스릴러",(주)넥스트엔터테인먼트월드(NEW),남자,남자,남자,0
825,재심,2017-02-15,2017-01-23,-23,1,1,282,100.0,1692000,1692000,282,282,0,드라마,"오퍼스픽쳐스(유),CGV아트하우스",남자,남자,남자,0
826,재심,2017-02-15,2017-02-02,-13,8,6,1894,96.7,12598000,14290000,1832,2114,0,드라마,"오퍼스픽쳐스(유),CGV아트하우스",남자,남자,남자,0
827,재심,2017-02-15,2017-02-06,-9,3,3,422,100.0,3080000,17370000,422,2536,0,드라마,"오퍼스픽쳐스(유),CGV아트하우스",남자,남자,남자,0
828,재심,2017-02-15,2017-02-07,-8,9,9,1816,100.0,14528000,31898000,1816,4352,0,드라마,"오퍼스픽쳐스(유),CGV아트하우스",남자,남자,남자,0
829,재심,2017-02-15,2017-02-08,-7,13,13,3187,99.0,23995000,55893000,3154,7506,0,드라마,"오퍼스픽쳐스(유),CGV아트하우스",남자,남자,남자,0
830,재심,2017-02-15,2017-02-09,-6,11,11,2252,100.0,17680000,73573000,2252,9758,0,드라마,"오퍼스픽쳐스(유),CGV아트하우스",남자,남자,남자,0
831,재심,2017-02-15,2017-02-13,-2,2,2,375,97.6,2528000,76101000,366,10124,0,드라마,"오퍼스픽쳐스(유),CGV아트하우스",남자,남자,남자,0
832,재심,2017-02-15,2017-02-14,-1,16,15,3044,98.9,21383000,97484000,3009,13133,0,드라마,"오퍼스픽쳐스(유),CGV아트하우스",남자,남자,남자,0
833,재심,2017-02-15,2017-02-15,0,3577,727,681871,17.8,916887400,1014371400,121122,134255,0,드라마,"오퍼스픽쳐스(유),CGV아트하우스",남자,남자,남자,0
834,재심,2017-02-15,2017-02-16,1,3664,789,702430,19.0,1005300000,2019671400,133292,267547,0,드라마,"오퍼스픽쳐스(유),CGV아트하우스",남자,남자,남자,0
835,재심,2017-02-15,2017-02-17,2,3920,831,752014,21.1,1325871259,3345542659,158861,426408,0,드라마,"오퍼스픽쳐스(유),CGV아트하우스",남자,남자,남자,0
836,재심,2017-02-15,2017-02-18,3,4454,935,860476,35.9,2609252599,5954795258,309045,735453,0,드라마,"오퍼스픽쳐스(유),CGV아트하우스",남자,남자,남자,0
837,재심,2017-02-15,2017-02-19,4,4358,924,845161,34.0,2430864550,8385659808,287337,1022790,0,드라마,"오퍼스픽쳐스(유),CGV아트하우스",남자,남자,남자,0
838,재심,2017-02-15,2017-02-20,5,4090,847,798134,14.3,855173500,9240833308,113754,1136544,0,드라마,"오퍼스픽쳐스(유),CGV아트하우스",남자,남자,남자,0
839,재심,2017-02-15,2017-02-21,6,4099,865,797876,13.3,794784200,10035617508,106084,1242628,0,드라마,"오퍼스픽쳐스(유),CGV아트하우스",남자,남자,남자,0
840,재심,2017-02-15,2017-02-22,7,2974,715,601067,21.3,762083300,10797700808,128189,1370817,0,드라마,"오퍼스픽쳐스(유),CGV아트하우스",남자,남자,남자,0
841,재심,2017-02-15,2017-02-23,8,2954,683,597334,12.9,577787600,11375488408,76857,1447674,0,드라마,"오퍼스픽쳐스(유),CGV아트하우스",남자,남자,남자,0
842,재심,2017-02-15,2017-02-24,9,3050,704,615186,14.3,732181628,12107670036,87870,1535544,0,드라마,"오퍼스픽쳐스(유),CGV아트하우스",남자,남자,남자,0
843,재심,2017-02-15,2017-02-25,10,3261,767,630540,28.4,1511003001,13618673037,179354,1714898,0,드라마,"오퍼스픽쳐스(유),CGV아트하우스",남자,남자,남자,0
844,재심,2017-02-15,2017-02-26,11,3190,755,612140,28.2,1452277600,15070950637,172320,1887218,0,드라마,"오퍼스픽쳐스(유),CGV아트하우스",남자,남자,남자,0
845,재심,2017-02-15,2017-02-27,12,3029,707,569369,11.5,488932000,15559882637,65625,1952843,0,드라마,"오퍼스픽쳐스(유),CGV아트하우스",남자,남자,남자,0
846,재심,2017-02-15,2017-02-28,13,2701,723,485559,16.0,573047300,16132929937,77863,2030706,0,드라마,"오퍼스픽쳐스(유),CGV아트하우스",남자,남자,남자,0
847,재심,2017-02-15,2017-03-01,14,1497,545,212960,37.8,663812800,16796742737,80454,2111160,0,드라마,"오퍼스픽쳐스(유),CGV아트하우스",남자,남자,남자,0
848,재심,2017-02-15,2017-03-02,15,1435,497,204365,10.8,163100700,16959843437,22108,2133268,0,드라마,"오퍼스픽쳐스(유),CGV아트하우스",남자,남자,남자,0
849,재심,2017-02-15,2017-03-03,16,1490,506,209857,11.9,204515100,17164358537,24979,2158247,0,드라마,"오퍼스픽쳐스(유),CGV아트하우스",남자,남자,남자,0
850,재심,2017-02-15,2017-03-04,17,1509,535,214275,26.8,482742100,17647100637,57437,2215684,0,드라마,"오퍼스픽쳐스(유),CGV아트하우스",남자,남자,남자,0
851,재심,2017-02-15,2017-03-05,18,1476,534,208867,24.5,431965100,18079065737,51240,2266924,0,드라마,"오퍼스픽쳐스(유),CGV아트하우스",남자,남자,남자,0
852,재심,2017-02-15,2017-03-06,19,1422,492,200024,7.8,115002000,18194067737,15650,2282574,0,드라마,"오퍼스픽쳐스(유),CGV아트하우스",남자,남자,남자,0
853,재심,2017-02-15,2017-03-07,20,1415,500,198899,7.8,112129000,18306196737,15439,2298013,0,드라마,"오퍼스픽쳐스(유),CGV아트하우스",남자,남자,남자,0
854,재심,2017-02-15,2017-03-08,21,1052,435,136443,8.6,85839800,18392036537,11769,2309782,0,드라마,"오퍼스픽쳐스(유),CGV아트하우스",남자,남자,남자,0
855,재심,2017-02-15,2017-03-09,22,880,386,116443,8.4,69909900,18461946437,9738,2319520,0,드라마,"오퍼스픽쳐스(유),CGV아트하우스",남자,남자,남자,0
856,재심,2017-02-15,2017-03-10,23,913,392,120270,9.2,91000800,18552947237,11066,2330586,0,드라마,"오퍼스픽쳐스(유),CGV아트하우스",남자,남자,남자,0
857,재심,2017-02-15,2017-03-11,24,933,420,120123,21.2,211736400,18764683637,25431,2356017,0,드라마,"오퍼스픽쳐스(유),CGV아트하우스",남자,남자,남자,0
858,재심,2017-02-15,2017-03-12,25,906,414,118395,21.2,208081200,18972764837,25144,2381161,0,드라마,"오퍼스픽쳐스(유),CGV아트하우스",남자,남자,남자,0
859,재심,2017-02-15,2017-03-13,26,903,396,116882,6.6,55338100,19028102937,7709,2388870,0,드라마,"오퍼스픽쳐스(유),CGV아트하우스",남자,남자,남자,0
860,재심,2017-02-15,2017-03-14,27,869,403,113207,7.1,57588200,19085691137,8009,2396879,0,드라마,"오퍼스픽쳐스(유),CGV아트하우스",남자,남자,남자,0
861,재심,2017-02-15,2017-03-15,28,868,383,112342,6.2,50404400,19136095537,6939,2403818,0,드라마,"오퍼스픽쳐스(유),CGV아트하우스",남자,남자,남자,0
862,재심,2017-02-15,2017-03-16,29,226,152,29466,8.7,17645500,19153741037,2575,2406393,0,드라마,"오퍼스픽쳐스(유),CGV아트하우스",남자,남자,남자,0
863,재심,2017-02-15,2017-03-17,30,221,142,28205,8.2,19252300,19172993337,2316,2408709,0,드라마,"오퍼스픽쳐스(유),CGV아트하우스",남자,남자,남자,0
864,재심,2017-02-15,2017-03-18,31,189,124,22659,15.9,30095000,19203088337,3601,2412310,0,드라마,"오퍼스픽쳐스(유),CGV아트하우스",남자,남자,남자,0
865,재심,2017-02-15,2017-03-19,32,172,120,20578,14.3,24776300,19227864637,2943,2415253,0,드라마,"오퍼스픽쳐스(유),CGV아트하우스",남자,남자,남자,0
866,재심,2017-02-15,2017-03-20,33,214,138,27395,5.2,10049000,19237913637,1422,2416675,0,드라마,"오퍼스픽쳐스(유),CGV아트하우스",남자,남자,남자,0
867,재심,2017-02-15,2017-03-21,34,222,147,27737,7.0,12502000,19250415637,1952,2418627,0,드라마,"오퍼스픽쳐스(유),CGV아트하우스",남자,남자,남자,0
868,재심,2017-02-15,2017-03-22,35,126,98,16857,4.0,4596000,19255011637,674,2419301,0,드라마,"오퍼스픽쳐스(유),CGV아트하우스",남자,남자,남자,0
869,재심,2017-02-15,2017-03-23,36,5,5,484,48.1,972000,19255983637,233,2419534,0,드라마,"오퍼스픽쳐스(유),CGV아트하우스",남자,남자,남자,0
870,재심,2017-02-15,2017-03-24,37,1,1,96,4.2,20000,19256003637,4,2419538,0,드라마,"오퍼스픽쳐스(유),CGV아트하우스",남자,남자,남자,0
871,재심,2017-02-15,2017-03-25,38,1,1,168,1.2,19000,19256022637,2,2419540,0,드라마,"오퍼스픽쳐스(유),CGV아트하우스",남자,남자,남자,0
872,재심,2017-02-15,2017-03-27,40,1,1,91,83.5,304000,19256326637,76,2419616,0,드라마,"오퍼스픽쳐스(유),CGV아트하우스",남자,남자,남자,0
873,재심,2017-02-15,2017-03-28,41,1,1,41,46.3,95000,19256421637,19,2419635,0,드라마,"오퍼스픽쳐스(유),CGV아트하우스",남자,남자,남자,0
874,재심,2017-02-15,2017-03-29,42,18,18,3136,14.9,3445000,19259866637,467,2420102,0,드라마,"오퍼스픽쳐스(유),CGV아트하우스",남자,남자,남자,0
875,재심,2017-02-15,2017-03-30,43,2,2,353,2.0,47000,19259913637,7,2420109,0,드라마,"오퍼스픽쳐스(유),CGV아트하우스",남자,남자,남자,0
876,재심,2017-02-15,2017-03-31,44,2,2,354,1.7,46000,19259959637,6,2420115,0,드라마,"오퍼스픽쳐스(유),CGV아트하우스",남자,남자,남자,0
877,재심,2017-02-15,2017-04-01,45,3,3,470,32.1,911000,19260870637,151,2420266,0,드라마,"오퍼스픽쳐스(유),CGV아트하우스",남자,남자,남자,0
878,재심,2017-02-15,2017-04-02,46,2,2,363,0.6,14000,19260884637,2,2420268,0,드라마,"오퍼스픽쳐스(유),CGV아트하우스",남자,남자,남자,0
879,재심,2017-02-15,2017-04-03,47,1,1,160,1.9,18000,19260902637,3,2420271,0,드라마,"오퍼스픽쳐스(유),CGV아트하우스",남자,남자,남자,0
880,재심,2017-02-15,2017-04-04,48,4,4,557,2.7,96000,19260998637,15,2420286,0,드라마,"오퍼스픽쳐스(유),CGV아트하우스",남자,남자,남자,0
881,재심,2017-02-15,2017-04-05,49,5,5,521,1.0,13000,19261011637,5,2420291,0,드라마,"오퍼스픽쳐스(유),CGV아트하우스",남자,남자,남자,0
882,재심,2017-02-15,2017-04-06,50,7,7,716,15.2,537000,19261548637,109,2420400,0,드라마,"오퍼스픽쳐스(유),CGV아트하우스",남자,남자,남자,0
883,재심,2017-02-15,2017-04-07,51,5,5,521,1.0,13000,19261561637,5,2420405,0,드라마,"오퍼스픽쳐스(유),CGV아트하우스",남자,남자,남자,0
884,재심,2017-02-15,2017-04-08,52,6,6,665,22.4,877000,19262438637,149,2420554,0,드라마,"오퍼스픽쳐스(유),CGV아트하우스",남자,남자,남자,0
885,재심,2017-02-15,2017-04-09,53,5,5,521,1.0,13000,19262451637,5,2420559,0,드라마,"오퍼스픽쳐스(유),CGV아트하우스",남자,남자,남자,0
886,재심,2017-02-15,2017-04-10,54,1,1,173,98.3,1000000,19263451637,170,2420729,0,드라마,"오퍼스픽쳐스(유),CGV아트하우스",남자,남자,남자,0
887,재심,2017-02-15,2017-04-14,58,2,2,342,72.5,1239000,19264690637,248,2420977,0,드라마,"오퍼스픽쳐스(유),CGV아트하우스",남자,남자,남자,0
888,재심,2017-02-15,2017-04-25,69,1,1,203,0.0,0,19264690637,0,2420977,0,드라마,"오퍼스픽쳐스(유),CGV아트하우스",남자,남자,남자,0
889,재심,2017-02-15,2017-04-26,70,2,2,140,24.3,102000,19264792637,34,2421011,0,드라마,"오퍼스픽쳐스(유),CGV아트하우스",남자,남자,남자,0
890,재심,2017-02-15,2017-04-30,74,1,1,214,0.0,0,19264792637,0,2421011,0,드라마,"오퍼스픽쳐스(유),CGV아트하우스",남자,남자,남자,0
891,재심,2017-02-15,2017-08-01,167,1,1,120,0.0,0,19264792637,0,2421011,0,드라마,"오퍼스픽쳐스(유),CGV아트하우스",남자,남자,남자,0
892,재심,2017-02-15,2017-09-21,218,1,1,186,100.0,1527000,19266319637,186,2421197,0,드라마,"오퍼스픽쳐스(유),CGV아트하우스",남자,남자,남자,0
893,재심,2017-02-15,2017-11-17,275,1,1,85,0.0,0,19266319637,0,2421197,0,드라마,"오퍼스픽쳐스(유),CGV아트하우스",남자,남자,남자,0
894,재심,2017-02-15,2017-11-21,279,1,1,85,0.0,0,19266319637,0,2421197,0,드라마,"오퍼스픽쳐스(유),CGV아트하우스",남자,남자,남자,0
895,조작된 도시,2017-02-09,2017-01-31,-9,9,4,2422,97.9,18316000,18316000,2371,2371,0,"범죄,액션",씨제이이앤엠(주),남자,남자,남자,0
896,조작된 도시,2017-02-09,2017-02-01,-8,4,4,953,94.4,5400000,23716000,900,3271,0,"범죄,액션",씨제이이앤엠(주),남자,남자,남자,0
897,조작된 도시,2017-02-09,2017-02-02,-7,10,10,3000,100.0,24000000,47716000,3000,6271,0,"범죄,액션",씨제이이앤엠(주),남자,남자,남자,0
898,조작된 도시,2017-02-09,2017-02-03,-6,3,3,911,82.3,4500000,52216000,750,7021,0,"범죄,액션",씨제이이앤엠(주),남자,남자,남자,0
899,조작된 도시,2017-02-09,2017-02-06,-3,9,9,1816,100.0,14528000,66744000,1816,8837,0,"범죄,액션",씨제이이앤엠(주),남자,남자,남자,0
900,조작된 도시,2017-02-09,2017-02-07,-2,34,34,7054,77.4,49941200,116685200,5457,14294,0,"범죄,액션",씨제이이앤엠(주),남자,남자,남자,0
901,조작된 도시,2017-02-09,2017-02-08,-1,29,20,6273,62.3,31882000,148567200,3909,18203,0,"범죄,액션",씨제이이앤엠(주),남자,남자,남자,0
902,조작된 도시,2017-02-09,2017-02-09,0,3503,771,678014,23.3,1177376000,1325943200,157669,175872,0,"범죄,액션",씨제이이앤엠(주),남자,남자,남자,0
903,조작된 도시,2017-02-09,2017-02-10,1,3784,825,734607,25.4,1551046539,2876989739,186738,362610,0,"범죄,액션",씨제이이앤엠(주),남자,남자,남자,0
904,조작된 도시,2017-02-09,2017-02-11,2,4495,1006,873233,40.5,2960746805,5837736544,353192,715802,0,"범죄,액션",씨제이이앤엠(주),남자,남자,남자,0
905,조작된 도시,2017-02-09,2017-02-12,3,4471,1019,868911,41.1,2985432400,8823168944,356648,1072450,0,"범죄,액션",씨제이이앤엠(주),남자,남자,남자,0
906,조작된 도시,2017-02-09,2017-02-13,4,4125,886,809405,16.1,978097300,9801266244,130484,1202934,0,"범죄,액션",씨제이이앤엠(주),남자,남자,남자,0
907,조작된 도시,2017-02-09,2017-02-14,5,4173,900,820667,17.6,1084946500,10886212744,144305,1347239,0,"범죄,액션",씨제이이앤엠(주),남자,남자,남자,0
908,조작된 도시,2017-02-09,2017-02-15,6,2878,686,528011,16.7,655763900,11541976644,88129,1435368,0,"범죄,액션",씨제이이앤엠(주),남자,남자,남자,0
909,조작된 도시,2017-02-09,2017-02-16,7,2923,729,537191,14.1,566544100,12108520744,75708,1511076,0,"범죄,액션",씨제이이앤엠(주),남자,남자,남자,0
910,조작된 도시,2017-02-09,2017-02-17,8,3218,773,601451,15.3,763363690,12871884434,91801,1602877,0,"범죄,액션",씨제이이앤엠(주),남자,남자,남자,0
911,조작된 도시,2017-02-09,2017-02-18,9,3516,829,656848,29.3,1620878074,14492762508,192248,1795125,0,"범죄,액션",씨제이이앤엠(주),남자,남자,남자,0
912,조작된 도시,2017-02-09,2017-02-19,10,3406,821,636875,28.1,1509223700,16001986208,179139,1974264,0,"범죄,액션",씨제이이앤엠(주),남자,남자,남자,0
913,조작된 도시,2017-02-09,2017-02-20,11,3130,738,574845,11.0,473420400,16475406608,63134,2037398,0,"범죄,액션",씨제이이앤엠(주),남자,남자,남자,0
914,조작된 도시,2017-02-09,2017-02-21,12,3145,747,573471,10.3,441554300,16916960908,59236,2096634,0,"범죄,액션",씨제이이앤엠(주),남자,남자,남자,0
915,조작된 도시,2017-02-09,2017-02-22,13,1694,520,272762,21.6,350908200,17267869108,58961,2155595,0,"범죄,액션",씨제이이앤엠(주),남자,남자,남자,0
916,조작된 도시,2017-02-09,2017-02-23,14,1661,500,260224,13.0,253174000,17521043108,33918,2189513,0,"범죄,액션",씨제이이앤엠(주),남자,남자,남자,0
917,조작된 도시,2017-02-09,2017-02-24,15,1656,515,255509,14.6,309739128,17830782236,37363,2226876,0,"범죄,액션",씨제이이앤엠(주),남자,남자,남자,0
918,조작된 도시,2017-02-09,2017-02-25,16,1691,545,257101,29.8,640086951,18470869187,76656,2303532,0,"범죄,액션",씨제이이앤엠(주),남자,남자,남자,0
919,조작된 도시,2017-02-09,2017-02-26,17,1634,538,248511,30.6,636204600,19107073787,76007,2379539,0,"범죄,액션",씨제이이앤엠(주),남자,남자,남자,0
920,조작된 도시,2017-02-09,2017-02-27,18,1596,498,239414,12.1,213595100,19320668887,28848,2408387,0,"범죄,액션",씨제이이앤엠(주),남자,남자,남자,0
921,조작된 도시,2017-02-09,2017-02-28,19,1346,516,197195,16.1,231674300,19552343187,31737,2440124,0,"범죄,액션",씨제이이앤엠(주),남자,남자,남자,0
922,조작된 도시,2017-02-09,2017-03-01,20,409,258,51695,35.7,149143600,19701486787,18446,2458570,0,"범죄,액션",씨제이이앤엠(주),남자,남자,남자,0
923,조작된 도시,2017-02-09,2017-03-02,21,405,263,54727,7.3,29531400,19731018187,3996,2462566,0,"범죄,액션",씨제이이앤엠(주),남자,남자,남자,0
924,조작된 도시,2017-02-09,2017-03-03,22,429,264,58387,9.1,43770800,19774788987,5293,2467859,0,"범죄,액션",씨제이이앤엠(주),남자,남자,남자,0
925,조작된 도시,2017-02-09,2017-03-04,23,438,259,56494,22.4,104955000,19879743987,12629,2480488,0,"범죄,액션",씨제이이앤엠(주),남자,남자,남자,0
926,조작된 도시,2017-02-09,2017-03-05,24,431,251,56245,21.2,99962400,19979706387,11901,2492389,0,"범죄,액션",씨제이이앤엠(주),남자,남자,남자,0
927,조작된 도시,2017-02-09,2017-03-06,25,412,236,54220,7.1,27730300,20007436687,3820,2496209,0,"범죄,액션",씨제이이앤엠(주),남자,남자,남자,0
928,조작된 도시,2017-02-09,2017-03-07,26,408,245,53723,6.3,24458700,20031895387,3377,2499586,0,"범죄,액션",씨제이이앤엠(주),남자,남자,남자,0
929,조작된 도시,2017-02-09,2017-03-08,27,185,112,22484,5.9,9308500,20041203887,1329,2500915,0,"범죄,액션",씨제이이앤엠(주),남자,남자,남자,0
930,조작된 도시,2017-02-09,2017-03-09,28,110,66,13656,6.4,6134900,20047338787,876,2501791,0,"범죄,액션",씨제이이앤엠(주),남자,남자,남자,0
931,조작된 도시,2017-02-09,2017-03-10,29,118,73,14279,7.0,8051900,20055390687,995,2502786,0,"범죄,액션",씨제이이앤엠(주),남자,남자,남자,0
932,조작된 도시,2017-02-09,2017-03-11,30,129,70,16215,15.6,20723500,20076114187,2523,2505309,0,"범죄,액션",씨제이이앤엠(주),남자,남자,남자,0
933,조작된 도시,2017-02-09,2017-03-12,31,128,78,15975,13.6,18228600,20094342787,2177,2507486,0,"범죄,액션",씨제이이앤엠(주),남자,남자,남자,0
934,조작된 도시,2017-02-09,2017-03-13,32,121,76,15621,4.4,5003500,20099346287,688,2508174,0,"범죄,액션",씨제이이앤엠(주),남자,남자,남자,0
935,조작된 도시,2017-02-09,2017-03-14,33,132,87,17654,8.5,8594000,20107940287,1503,2509677,0,"범죄,액션",씨제이이앤엠(주),남자,남자,남자,0
936,조작된 도시,2017-02-09,2017-03-15,34,132,82,16800,6.3,7035400,20114975687,1060,2510737,0,"범죄,액션",씨제이이앤엠(주),남자,남자,남자,0
937,조작된 도시,2017-02-09,2017-03-16,35,29,27,3650,34.3,5373500,20120349187,1251,2511988,0,"범죄,액션",씨제이이앤엠(주),남자,남자,남자,0
938,조작된 도시,2017-02-09,2017-03-17,36,4,2,549,27.9,825000,20121174187,153,2512141,0,"범죄,액션",씨제이이앤엠(주),남자,남자,남자,0
939,조작된 도시,2017-02-09,2017-03-18,37,13,11,1700,24.7,2048400,20123222587,419,2512560,0,"범죄,액션",씨제이이앤엠(주),남자,남자,남자,0
940,조작된 도시,2017-02-09,2017-03-19,38,4,2,516,16.1,613000,20123835587,83,2512643,0,"범죄,액션",씨제이이앤엠(주),남자,남자,남자,0
941,조작된 도시,2017-02-09,2017-03-20,39,9,6,1358,4.6,449000,20124284587,63,2512706,0,"범죄,액션",씨제이이앤엠(주),남자,남자,남자,0
942,조작된 도시,2017-02-09,2017-03-21,40,4,4,488,19.1,529000,20124813587,93,2512799,0,"범죄,액션",씨제이이앤엠(주),남자,남자,남자,0
943,조작된 도시,2017-02-09,2017-03-22,41,7,6,1135,16.0,952000,20125765587,181,2512980,0,"범죄,액션",씨제이이앤엠(주),남자,남자,남자,0
944,조작된 도시,2017-02-09,2017-03-23,42,5,5,935,19.6,938000,20126703587,183,2513163,0,"범죄,액션",씨제이이앤엠(주),남자,남자,남자,0
945,조작된 도시,2017-02-09,2017-03-24,43,5,5,932,17.0,814000,20127517587,158,2513321,0,"범죄,액션",씨제이이앤엠(주),남자,남자,남자,0
946,조작된 도시,2017-02-09,2017-03-25,44,5,5,830,22.5,1058000,20128575587,187,2513508,0,"범죄,액션",씨제이이앤엠(주),남자,남자,남자,0
947,조작된 도시,2017-02-09,2017-03-26,45,5,5,829,19.9,843000,20129418587,165,2513673,0,"범죄,액션",씨제이이앤엠(주),남자,남자,남자,0
948,조작된 도시,2017-02-09,2017-03-27,46,5,5,886,15.4,687500,20130106087,136,2513809,0,"범죄,액션",씨제이이앤엠(주),남자,남자,남자,0
949,조작된 도시,2017-02-09,2017-03-28,47,5,5,920,18.9,913500,20131019587,174,2513983,0,"범죄,액션",씨제이이앤엠(주),남자,남자,남자,0
950,조작된 도시,2017-02-09,2017-03-29,48,2,2,364,100.0,2912000,20133931587,364,2514347,0,"범죄,액션",씨제이이앤엠(주),남자,남자,남자,0
951,조작된 도시,2017-02-09,2017-03-30,49,3,3,463,90.9,3344000,20137275587,421,2514768,0,"범죄,액션",씨제이이앤엠(주),남자,남자,남자,0
952,조작된 도시,2017-02-09,2017-04-03,53,1,1,165,18.2,150000,20137425587,30,2514798,0,"범죄,액션",씨제이이앤엠(주),남자,남자,남자,0
953,조작된 도시,2017-02-09,2017-04-06,56,1,1,36,97.2,210000,20137635587,35,2514833,0,"범죄,액션",씨제이이앤엠(주),남자,남자,남자,0
954,조작된 도시,2017-02-09,2017-04-18,68,1,1,111,99.1,660000,20138295587,110,2514943,0,"범죄,액션",씨제이이앤엠(주),남자,남자,남자,0
955,조작된 도시,2017-02-09,2017-09-02,205,1,1,186,100.0,1899000,20140194587,186,2515129,0,"범죄,액션",씨제이이앤엠(주),남자,남자,남자,0
956,조작된 도시,2017-02-09,2017-10-15,248,1,1,186,100.0,1899000,20142093587,186,2515315,0,"범죄,액션",씨제이이앤엠(주),남자,남자,남자,0
957,조작된 도시,2017-02-09,2017-11-25,289,1,1,186,100.0,1899000,20143992587,186,2515501,0,"범죄,액션",씨제이이앤엠(주),남자,남자,남자,0
958,조작된 도시,2017-02-09,2019-07-26,897,1,1,89,100.0,712000,20144704587,89,2515590,0,"범죄,액션",씨제이이앤엠(주),남자,남자,남자,0
959,프리즌,2017-03-23,2017-03-06,-17,9,9,1544,73.1,8319000,8319000,1129,1129,0,"범죄,액션",(주)쇼박스,남자,남자,남자,0
960,프리즌,2017-03-23,2017-03-07,-16,16,16,2725,82.3,17219000,25538000,2243,3372,0,"범죄,액션",(주)쇼박스,남자,남자,남자,0
961,프리즌,2017-03-23,2017-03-08,-15,3,3,474,100.0,3556000,29094000,474,3846,0,"범죄,액션",(주)쇼박스,남자,남자,남자,0
962,프리즌,2017-03-23,2017-03-14,-9,14,14,3806,99.5,30603000,59697000,3788,7634,0,"범죄,액션",(주)쇼박스,남자,남자,남자,0
963,프리즌,2017-03-23,2017-03-15,-8,5,5,906,100.0,7943000,67640000,906,8540,0,"범죄,액션",(주)쇼박스,남자,남자,남자,0
964,프리즌,2017-03-23,2017-03-16,-7,1,1,221,0.0,0,67640000,0,8540,0,"범죄,액션",(주)쇼박스,남자,남자,남자,0
965,프리즌,2017-03-23,2017-03-17,-6,42,42,8344,99.6,74826000,142466000,8314,16854,0,"범죄,액션",(주)쇼박스,남자,남자,남자,0
966,프리즌,2017-03-23,2017-03-18,-5,1,1,134,100.0,1206000,143672000,134,16988,0,"범죄,액션",(주)쇼박스,남자,남자,남자,0
967,프리즌,2017-03-23,2017-03-19,-4,25,12,828,100.0,9108000,152780000,828,17816,0,"범죄,액션",(주)쇼박스,남자,남자,남자,0
968,프리즌,2017-03-23,2017-03-20,-3,17,17,3581,48.3,19302000,172082000,1731,19547,0,"범죄,액션",(주)쇼박스,남자,남자,남자,0
969,프리즌,2017-03-23,2017-03-21,-2,13,13,3402,104.4,28259000,200341000,3551,23098,0,"범죄,액션",(주)쇼박스,남자,남자,남자,0
970,프리즌,2017-03-23,2017-03-22,-1,2417,871,417184,20.4,661246800,861587800,85056,108154,0,"범죄,액션",(주)쇼박스,남자,남자,남자,0
971,프리즌,2017-03-23,2017-03-23,0,4234,909,783051,21.5,1257773300,2119361100,168336,276490,0,"범죄,액션",(주)쇼박스,남자,남자,남자,0
972,프리즌,2017-03-23,2017-03-24,1,4453,942,823411,23.6,1641165534,3760526634,194224,470714,0,"범죄,액션",(주)쇼박스,남자,남자,남자,0
973,프리즌,2017-03-23,2017-03-25,2,4889,1047,879442,45.8,3439513889,7200040523,403084,873798,0,"범죄,액션",(주)쇼박스,남자,남자,남자,0
974,프리즌,2017-03-23,2017-03-26,3,4772,1036,857768,43.1,3170344300,10370384823,369870,1243668,0,"범죄,액션",(주)쇼박스,남자,남자,남자,0
975,프리즌,2017-03-23,2017-03-27,4,4551,962,829064,15.9,987093300,11357478123,131499,1375167,0,"범죄,액션",(주)쇼박스,남자,남자,남자,0
976,프리즌,2017-03-23,2017-03-28,5,4555,977,827744,13.1,809719450,12167197573,108066,1483233,0,"범죄,액션",(주)쇼박스,남자,남자,남자,0
977,프리즌,2017-03-23,2017-03-29,6,3363,785,594420,22.9,808985100,12976182673,136337,1619570,0,"범죄,액션",(주)쇼박스,남자,남자,남자,0
978,프리즌,2017-03-23,2017-03-30,7,3383,771,600873,13.5,609911900,13586094573,81339,1700909,0,"범죄,액션",(주)쇼박스,남자,남자,남자,0
979,프리즌,2017-03-23,2017-03-31,8,3611,820,641984,17.3,934868387,14520962960,111341,1812250,0,"범죄,액션",(주)쇼박스,남자,남자,남자,0
980,프리즌,2017-03-23,2017-04-01,9,3854,908,689671,32.6,1938640180,16459603140,224529,2036779,0,"범죄,액션",(주)쇼박스,남자,남자,남자,0
981,프리즌,2017-03-23,2017-04-02,10,3766,881,672842,26.5,1538943500,17998546640,178045,2214824,0,"범죄,액션",(주)쇼박스,남자,남자,남자,0
982,프리즌,2017-03-23,2017-04-03,11,3505,787,616719,9.9,457732200,18456278840,60719,2275543,0,"범죄,액션",(주)쇼박스,남자,남자,남자,0
983,프리즌,2017-03-23,2017-04-04,12,3402,791,606145,8.5,387888000,18844166840,51701,2327244,0,"범죄,액션",(주)쇼박스,남자,남자,남자,0
984,프리즌,2017-03-23,2017-04-05,13,2775,661,474734,10.8,385939900,19230106740,51173,2378417,0,"범죄,액션",(주)쇼박스,남자,남자,남자,0
985,프리즌,2017-03-23,2017-04-06,14,2430,583,425292,11.2,356401900,19586508640,47467,2425884,0,"범죄,액션",(주)쇼박스,남자,남자,남자,0
986,프리즌,2017-03-23,2017-04-07,15,2572,627,448353,11.7,445426377,20031935017,52309,2478193,0,"범죄,액션",(주)쇼박스,남자,남자,남자,0
987,프리즌,2017-03-23,2017-04-08,16,2966,743,531104,19.2,885023470,20916958487,102167,2580360,0,"범죄,액션",(주)쇼박스,남자,남자,남자,0
988,프리즌,2017-03-23,2017-04-09,17,2879,725,518259,18.4,831151600,21748110087,95374,2675734,0,"범죄,액션",(주)쇼박스,남자,남자,남자,0
989,프리즌,2017-03-23,2017-04-10,18,2591,638,452786,7.1,241795200,21989905287,32013,2707747,0,"범죄,액션",(주)쇼박스,남자,남자,남자,0
990,프리즌,2017-03-23,2017-04-11,19,2585,646,449796,6.9,234043000,22223948287,31082,2738829,0,"범죄,액션",(주)쇼박스,남자,남자,남자,0
991,프리즌,2017-03-23,2017-04-12,20,1573,451,224813,7.8,132616200,22356564487,17603,2756432,0,"범죄,액션",(주)쇼박스,남자,남자,남자,0
992,프리즌,2017-03-23,2017-04-13,21,1497,445,215013,6.9,112757400,22469321887,14899,2771331,0,"범죄,액션",(주)쇼박스,남자,남자,남자,0
993,프리즌,2017-03-23,2017-04-14,22,1555,472,224277,9.2,174922600,22644244487,20584,2791915,0,"범죄,액션",(주)쇼박스,남자,남자,남자,0
994,프리즌,2017-03-23,2017-04-15,23,1310,494,183812,17.4,275359500,22919603987,32038,2823953,0,"범죄,액션",(주)쇼박스,남자,남자,남자,0
995,프리즌,2017-03-23,2017-04-16,24,1258,494,175475,14.9,226336700,23145940687,26181,2850134,0,"범죄,액션",(주)쇼박스,남자,남자,남자,0
996,프리즌,2017-03-23,2017-04-17,25,1370,449,189659,7.7,109731400,23255672087,14531,2864665,0,"범죄,액션",(주)쇼박스,남자,남자,남자,0
997,프리즌,2017-03-23,2017-04-18,26,1322,447,183031,5.9,81076700,23336748787,10861,2875526,0,"범죄,액션",(주)쇼박스,남자,남자,남자,0
998,프리즌,2017-03-23,2017-04-19,27,1318,447,183725,5.5,76113700,23412862487,10127,2885653,0,"범죄,액션",(주)쇼박스,남자,남자,남자,0
999,프리즌,2017-03-23,2017-04-20,28,629,332,81362,6.8,41412000,23454274487,5497,2891150,0,"범죄,액션",(주)쇼박스,남자,남자,남자,0
1000,프리즌,2017-03-23,2017-04-21,29,653,348,85193,7.6,54883700,23509158187,6488,2897638,0,"범죄,액션",(주)쇼박스,남자,남자,남자,0
1001,프리즌,2017-03-23,2017-04-22,30,652,349,85936,14.3,105377800,23614535987,12262,2909900,0,"범죄,액션",(주)쇼박스,남자,남자,남자,0
1002,프리즌,2017-03-23,2017-04-23,31,634,347,83016,12.8,92897800,23707433787,10630,2920530,0,"범죄,액션",(주)쇼박스,남자,남자,남자,0
1003,프리즌,2017-03-23,2017-04-24,32,671,334,88018,5.6,36667400,23744101187,4888,2925418,0,"범죄,액션",(주)쇼박스,남자,남자,남자,0
1004,프리즌,2017-03-23,2017-04-25,33,644,334,85968,4.9,31025800,23775126987,4167,2929585,0,"범죄,액션",(주)쇼박스,남자,남자,남자,0
1005,프리즌,2017-03-23,2017-04-26,34,58,40,7121,5.2,2444000,23777570987,367,2929952,0,"범죄,액션",(주)쇼박스,남자,남자,남자,0
1006,프리즌,2017-03-23,2017-04-27,35,32,19,3543,3.6,989500,23778560487,128,2930080,0,"범죄,액션",(주)쇼박스,남자,남자,남자,0
1007,프리즌,2017-03-23,2017-04-28,36,26,17,2840,6.3,1575000,23780135487,179,2930259,0,"범죄,액션",(주)쇼박스,남자,남자,남자,0
1008,프리즌,2017-03-23,2017-04-29,37,21,14,2115,9.6,1724000,23781859487,202,2930461,0,"범죄,액션",(주)쇼박스,남자,남자,남자,0
1009,프리즌,2017-03-23,2017-04-30,38,17,12,1852,8.4,1388000,23783247487,155,2930616,0,"범죄,액션",(주)쇼박스,남자,남자,남자,0
1010,프리즌,2017-03-23,2017-05-01,39,21,10,2489,8.5,1533000,23784780487,212,2930828,0,"범죄,액션",(주)쇼박스,남자,남자,남자,0
1011,프리즌,2017-03-23,2017-05-02,40,12,8,1527,4.5,496500,23785276987,69,2930897,0,"범죄,액션",(주)쇼박스,남자,남자,남자,0
1012,프리즌,2017-03-23,2017-05-03,41,5,5,754,13.3,500000,23785776987,100,2930997,0,"범죄,액션",(주)쇼박스,남자,남자,남자,0
1013,프리즌,2017-03-23,2017-05-04,42,5,5,730,13.7,500000,23786276987,100,2931097,0,"범죄,액션",(주)쇼박스,남자,남자,남자,0
1014,프리즌,2017-03-23,2017-05-05,43,5,5,734,13.6,500000,23786776987,100,2931197,0,"범죄,액션",(주)쇼박스,남자,남자,남자,0
1015,프리즌,2017-03-23,2017-05-06,44,5,5,730,13.7,500000,23787276987,100,2931297,0,"범죄,액션",(주)쇼박스,남자,남자,남자,0
1016,프리즌,2017-03-23,2017-05-07,45,5,5,730,13.7,500000,23787776987,100,2931397,0,"범죄,액션",(주)쇼박스,남자,남자,남자,0
1017,프리즌,2017-03-23,2017-05-08,46,5,5,674,14.8,500000,23788276987,100,2931497,0,"범죄,액션",(주)쇼박스,남자,남자,남자,0
1018,프리즌,2017-03-23,2017-05-09,47,5,5,879,11.4,500000,23788776987,100,2931597,0,"범죄,액션",(주)쇼박스,남자,남자,남자,0
1019,프리즌,2017-03-23,2017-05-10,48,5,5,878,11.4,500000,23789276987,100,2931697,0,"범죄,액션",(주)쇼박스,남자,남자,남자,0
1020,프리즌,2017-03-23,2017-05-11,49,5,5,807,12.4,500000,23789776987,100,2931797,0,"범죄,액션",(주)쇼박스,남자,남자,남자,0
1021,프리즌,2017-03-23,2017-05-12,50,5,5,798,12.5,500000,23790276987,100,2931897,0,"범죄,액션",(주)쇼박스,남자,남자,남자,0
1022,프리즌,2017-03-23,2017-06-29,98,1,1,144,0.0,0,23790276987,0,2931897,0,"범죄,액션",(주)쇼박스,남자,남자,남자,0
1023,프리즌,2017-03-23,2017-11-20,242,1,1,224,0.0,0,23790276987,0,2931897,0,"범죄,액션",(주)쇼박스,남자,남자,남자,0
1024,보안관,2017-05-03,2017-04-10,-23,1,1,401,100.0,2406000,2406000,401,401,0,"범죄,코미디",롯데컬처웍스(주)롯데엔터테인먼트,남자,남자,남자,0
1025,보안관,2017-05-03,2017-04-18,-15,7,7,1578,80.0,10104000,12510000,1263,1664,0,"범죄,코미디",롯데컬처웍스(주)롯데엔터테인먼트,남자,남자,남자,0
1026,보안관,2017-05-03,2017-04-19,-14,13,13,2742,48.3,10584000,23094000,1323,2987,0,"범죄,코미디",롯데컬처웍스(주)롯데엔터테인먼트,남자,남자,남자,0
1027,보안관,2017-05-03,2017-04-20,-13,13,13,1953,82.7,12920000,36014000,1615,4602,0,"범죄,코미디",롯데컬처웍스(주)롯데엔터테인먼트,남자,남자,남자,0
1028,보안관,2017-05-03,2017-04-24,-9,2,2,675,100.0,5400000,41414000,675,5277,0,"범죄,코미디",롯데컬처웍스(주)롯데엔터테인먼트,남자,남자,남자,0
1029,보안관,2017-05-03,2017-04-25,-8,11,11,2119,73.3,12275000,53689000,1553,6830,0,"범죄,코미디",롯데컬처웍스(주)롯데엔터테인먼트,남자,남자,남자,0
1030,보안관,2017-05-03,2017-04-26,-7,12,12,2791,87.3,19488000,73177000,2436,9266,0,"범죄,코미디",롯데컬처웍스(주)롯데엔터테인먼트,남자,남자,남자,0
1031,보안관,2017-05-03,2017-04-27,-6,2,2,402,41.3,1328000,74505000,166,9432,0,"범죄,코미디",롯데컬처웍스(주)롯데엔터테인먼트,남자,남자,남자,0
1032,보안관,2017-05-03,2017-04-28,-5,31,31,6304,99.0,58540000,133045000,6240,15672,0,"범죄,코미디",롯데컬처웍스(주)롯데엔터테인먼트,남자,남자,남자,0
1033,보안관,2017-05-03,2017-04-29,-4,7,7,1639,88.7,13827900,146872900,1454,17126,0,"범죄,코미디",롯데컬처웍스(주)롯데엔터테인먼트,남자,남자,남자,0
1034,보안관,2017-05-03,2017-05-02,-1,24,24,5848,86.0,42213000,189085900,5028,22154,0,"범죄,코미디",롯데컬처웍스(주)롯데엔터테인먼트,남자,남자,남자,0
1035,보안관,2017-05-03,2017-05-03,0,2682,669,406320,50.9,1707833700,1896919600,206706,228860,0,"범죄,코미디",롯데컬처웍스(주)롯데엔터테인먼트,남자,남자,남자,0
1036,보안관,2017-05-03,2017-05-04,1,2864,758,435977,44.5,1426211000,3323130600,193863,422723,0,"범죄,코미디",롯데컬처웍스(주)롯데엔터테인먼트,남자,남자,남자,0
1037,보안관,2017-05-03,2017-05-05,2,3062,878,470597,59.8,2320947094,5644077694,281401,704124,0,"범죄,코미디",롯데컬처웍스(주)롯데엔터테인먼트,남자,남자,남자,0
1038,보안관,2017-05-03,2017-05-06,3,3812,1069,614836,47.8,2452801346,8096879040,294102,998226,0,"범죄,코미디",롯데컬처웍스(주)롯데엔터테인먼트,남자,남자,남자,0
1039,보안관,2017-05-03,2017-05-07,4,4030,1091,663817,39.5,2210941500,10307820540,261919,1260145,0,"범죄,코미디",롯데컬처웍스(주)롯데엔터테인먼트,남자,남자,남자,0
1040,보안관,2017-05-03,2017-05-08,5,4299,947,754678,19.9,1106714000,11414534540,149813,1409958,0,"범죄,코미디",롯데컬처웍스(주)롯데엔터테인먼트,남자,남자,남자,0
1041,보안관,2017-05-03,2017-05-09,6,3366,806,621433,38.9,1988366800,13402901340,241627,1651585,0,"범죄,코미디",롯데컬처웍스(주)롯데엔터테인먼트,남자,남자,남자,0
1042,보안관,2017-05-03,2017-05-10,7,3229,696,579648,11.2,481728600,13884629940,65039,1716624,0,"범죄,코미디",롯데컬처웍스(주)롯데엔터테인먼트,남자,남자,남자,0
1043,보안관,2017-05-03,2017-05-11,8,3217,699,580382,11.1,474274400,14358904340,64302,1780926,0,"범죄,코미디",롯데컬처웍스(주)롯데엔터테인먼트,남자,남자,남자,0
1044,보안관,2017-05-03,2017-05-12,9,3367,748,604465,14.3,709803222,15068707562,86702,1867628,0,"범죄,코미디",롯데컬처웍스(주)롯데엔터테인먼트,남자,남자,남자,0
1045,보안관,2017-05-03,2017-05-13,10,3352,758,611257,28.5,1475699847,16544407409,174313,2041941,0,"범죄,코미디",롯데컬처웍스(주)롯데엔터테인먼트,남자,남자,남자,0
1046,보안관,2017-05-03,2017-05-14,11,3236,751,588294,28.0,1389646100,17934053509,164624,2206565,0,"범죄,코미디",롯데컬처웍스(주)롯데엔터테인먼트,남자,남자,남자,0
1047,보안관,2017-05-03,2017-05-15,12,3246,714,573743,11.2,470701000,18404754509,64447,2271012,0,"범죄,코미디",롯데컬처웍스(주)롯데엔터테인먼트,남자,남자,남자,0
1048,보안관,2017-05-03,2017-05-16,13,3262,732,573097,9.1,380132700,18784887209,52173,2323185,0,"범죄,코미디",롯데컬처웍스(주)롯데엔터테인먼트,남자,남자,남자,0
1049,보안관,2017-05-03,2017-05-17,14,2136,603,326559,8.6,202147700,18987034909,28064,2351249,0,"범죄,코미디",롯데컬처웍스(주)롯데엔터테인먼트,남자,남자,남자,0
1050,보안관,2017-05-03,2017-05-18,15,2000,589,311357,7.9,176399500,19163434409,24608,2375857,0,"범죄,코미디",롯데컬처웍스(주)롯데엔터테인먼트,남자,남자,남자,0
1051,보안관,2017-05-03,2017-05-19,16,2018,605,307564,9.6,235093200,19398527609,29514,2405371,0,"범죄,코미디",롯데컬처웍스(주)롯데엔터테인먼트,남자,남자,남자,0
1052,보안관,2017-05-03,2017-05-20,17,1873,530,279978,19.4,450810600,19849338209,54356,2459727,0,"범죄,코미디",롯데컬처웍스(주)롯데엔터테인먼트,남자,남자,남자,0
1053,보안관,2017-05-03,2017-05-21,18,1756,532,261266,19.0,415640900,20264979109,49740,2509467,0,"범죄,코미디",롯데컬처웍스(주)롯데엔터테인먼트,남자,남자,남자,0
1054,보안관,2017-05-03,2017-05-22,19,1743,511,244647,6.6,117706200,20382685309,16135,2525602,0,"범죄,코미디",롯데컬처웍스(주)롯데엔터테인먼트,남자,남자,남자,0
1055,보안관,2017-05-03,2017-05-23,20,1709,512,239851,6.4,110498300,20493183609,15334,2540936,0,"범죄,코미디",롯데컬처웍스(주)롯데엔터테인먼트,남자,남자,남자,0
1056,보안관,2017-05-03,2017-05-24,21,789,334,99043,8.6,59466000,20552649609,8478,2549414,0,"범죄,코미디",롯데컬처웍스(주)롯데엔터테인먼트,남자,남자,남자,0
1057,보안관,2017-05-03,2017-05-25,22,437,250,55584,9.7,36578300,20589227909,5386,2554800,0,"범죄,코미디",롯데컬처웍스(주)롯데엔터테인먼트,남자,남자,남자,0
1058,보안관,2017-05-03,2017-05-26,23,419,239,53203,10.6,44058400,20633286309,5611,2560411,0,"범죄,코미디",롯데컬처웍스(주)롯데엔터테인먼트,남자,남자,남자,0
1059,보안관,2017-05-03,2017-05-27,24,335,222,40500,20.4,67881700,20701168009,8253,2568664,0,"범죄,코미디",롯데컬처웍스(주)롯데엔터테인먼트,남자,남자,남자,0
1060,보안관,2017-05-03,2017-05-28,25,321,212,38778,17.8,57974500,20759142509,6906,2575570,0,"범죄,코미디",롯데컬처웍스(주)롯데엔터테인먼트,남자,남자,남자,0
1061,보안관,2017-05-03,2017-05-29,26,390,230,47823,6.3,21935500,20781078009,3030,2578600,0,"범죄,코미디",롯데컬처웍스(주)롯데엔터테인먼트,남자,남자,남자,0
1062,보안관,2017-05-03,2017-05-30,27,375,223,46429,7.3,23777500,20804855509,3407,2582007,0,"범죄,코미디",롯데컬처웍스(주)롯데엔터테인먼트,남자,남자,남자,0
1063,보안관,2017-05-03,2017-05-31,28,37,31,4814,13.9,4078500,20808934009,669,2582676,0,"범죄,코미디",롯데컬처웍스(주)롯데엔터테인먼트,남자,남자,남자,0
1064,보안관,2017-05-03,2017-06-01,29,25,18,3012,8.6,1724500,20810658509,260,2582936,0,"범죄,코미디",롯데컬처웍스(주)롯데엔터테인먼트,남자,남자,남자,0
1065,보안관,2017-05-03,2017-06-02,30,20,18,2824,4.8,1138000,20811796509,136,2583072,0,"범죄,코미디",롯데컬처웍스(주)롯데엔터테인먼트,남자,남자,남자,0
1066,보안관,2017-05-03,2017-06-03,31,21,18,2562,9.1,1940500,20813737009,233,2583305,0,"범죄,코미디",롯데컬처웍스(주)롯데엔터테인먼트,남자,남자,남자,0
1067,보안관,2017-05-03,2017-06-04,32,22,19,2891,8.8,2149000,20815886009,253,2583558,0,"범죄,코미디",롯데컬처웍스(주)롯데엔터테인먼트,남자,남자,남자,0
1068,보안관,2017-05-03,2017-06-05,33,28,22,2986,7.9,1710500,20817596509,236,2583794,0,"범죄,코미디",롯데컬처웍스(주)롯데엔터테인먼트,남자,남자,남자,0
1069,보안관,2017-05-03,2017-06-06,34,3,3,371,6.5,228000,20817824509,24,2583818,0,"범죄,코미디",롯데컬처웍스(주)롯데엔터테인먼트,남자,남자,남자,0
1070,보안관,2017-05-03,2017-06-07,35,5,4,598,2.5,123500,20817948009,15,2583833,0,"범죄,코미디",롯데컬처웍스(주)롯데엔터테인먼트,남자,남자,남자,0
1071,보안관,2017-05-03,2017-06-08,36,2,2,349,21.8,453500,20818401509,76,2583909,0,"범죄,코미디",롯데컬처웍스(주)롯데엔터테인먼트,남자,남자,남자,0
1072,보안관,2017-05-03,2017-06-09,37,4,4,510,2.2,97000,20818498509,11,2583920,0,"범죄,코미디",롯데컬처웍스(주)롯데엔터테인먼트,남자,남자,남자,0
1073,보안관,2017-05-03,2017-06-10,38,4,4,466,6.0,193000,20818691509,28,2583948,0,"범죄,코미디",롯데컬처웍스(주)롯데엔터테인먼트,남자,남자,남자,0
1074,보안관,2017-05-03,2017-06-11,39,4,4,494,5.3,177000,20818868509,26,2583974,0,"범죄,코미디",롯데컬처웍스(주)롯데엔터테인먼트,남자,남자,남자,0
1075,보안관,2017-05-03,2017-06-12,40,4,4,566,1.1,35000,20818903509,6,2583980,0,"범죄,코미디",롯데컬처웍스(주)롯데엔터테인먼트,남자,남자,남자,0
1076,보안관,2017-05-03,2017-06-13,41,6,6,858,2.3,154000,20819057509,20,2584000,0,"범죄,코미디",롯데컬처웍스(주)롯데엔터테인먼트,남자,남자,남자,0
1077,보안관,2017-05-03,2017-06-14,42,3,3,454,2.9,97000,20819154509,13,2584013,0,"범죄,코미디",롯데컬처웍스(주)롯데엔터테인먼트,남자,남자,남자,0
1078,보안관,2017-05-03,2017-06-15,43,5,5,795,22.6,1070000,20820224509,180,2584193,0,"범죄,코미디",롯데컬처웍스(주)롯데엔터테인먼트,남자,남자,남자,0
1079,보안관,2017-05-03,2017-06-16,44,10,10,1551,46.2,4416400,20824640909,716,2584909,0,"범죄,코미디",롯데컬처웍스(주)롯데엔터테인먼트,남자,남자,남자,0
1080,보안관,2017-05-03,2017-06-17,45,5,5,912,11.1,716000,20825356909,101,2585010,0,"범죄,코미디",롯데컬처웍스(주)롯데엔터테인먼트,남자,남자,남자,0
1081,보안관,2017-05-03,2017-06-18,46,5,5,912,18.9,1286500,20826643409,172,2585182,0,"범죄,코미디",롯데컬처웍스(주)롯데엔터테인먼트,남자,남자,남자,0
1082,보안관,2017-05-03,2017-06-19,47,5,5,689,16.7,847000,20827490409,115,2585297,0,"범죄,코미디",롯데컬처웍스(주)롯데엔터테인먼트,남자,남자,남자,0
1083,보안관,2017-05-03,2017-06-20,48,9,7,1303,45.2,2836000,20830326409,589,2585886,0,"범죄,코미디",롯데컬처웍스(주)롯데엔터테인먼트,남자,남자,남자,0
1084,보안관,2017-05-03,2017-06-21,49,10,8,1474,37.1,2454000,20832780409,547,2586433,0,"범죄,코미디",롯데컬처웍스(주)롯데엔터테인먼트,남자,남자,남자,0
1085,보안관,2017-05-03,2017-06-22,50,5,3,929,82.4,4005000,20836785409,765,2587198,0,"범죄,코미디",롯데컬처웍스(주)롯데엔터테인먼트,남자,남자,남자,0
1086,보안관,2017-05-03,2017-06-23,51,4,2,614,73.3,1800000,20838585409,450,2587648,0,"범죄,코미디",롯데컬처웍스(주)롯데엔터테인먼트,남자,남자,남자,0
1087,보안관,2017-05-03,2017-06-27,55,2,2,309,86.4,1068000,20839653409,267,2587915,0,"범죄,코미디",롯데컬처웍스(주)롯데엔터테인먼트,남자,남자,남자,0
1088,보안관,2017-05-03,2017-06-29,57,2,2,393,21.6,510000,20840163409,85,2588000,0,"범죄,코미디",롯데컬처웍스(주)롯데엔터테인먼트,남자,남자,남자,0
1089,보안관,2017-05-03,2017-07-18,76,1,1,250,100.0,1500000,20841663409,250,2588250,0,"범죄,코미디",롯데컬처웍스(주)롯데엔터테인먼트,남자,남자,남자,0
1090,보안관,2017-05-03,2017-07-20,78,1,1,194,100.0,1358000,20843021409,194,2588444,0,"범죄,코미디",롯데컬처웍스(주)롯데엔터테인먼트,남자,남자,남자,0
1091,보안관,2017-05-03,2017-08-02,91,1,1,173,100.0,1384000,20844405409,173,2588617,0,"범죄,코미디",롯데컬처웍스(주)롯데엔터테인먼트,남자,남자,남자,0
1092,보안관,2017-05-03,2017-09-01,121,1,1,186,0.0,0,20844405409,0,2588617,0,"범죄,코미디",롯데컬처웍스(주)롯데엔터테인먼트,남자,남자,남자,0
1093,보안관,2017-05-03,2017-10-14,164,3,1,288,3.1,69000,20844474409,9,2588626,0,"범죄,코미디",롯데컬처웍스(주)롯데엔터테인먼트,남자,남자,남자,0
1094,보안관,2017-05-03,2017-10-26,176,1,1,43,0.0,0,20844474409,0,2588626,0,"범죄,코미디",롯데컬처웍스(주)롯데엔터테인먼트,남자,남자,남자,0
1095,보안관,2017-05-03,2017-10-31,181,1,1,96,2.1,14000,20844488409,2,2588628,0,"범죄,코미디",롯데컬처웍스(주)롯데엔터테인먼트,남자,남자,남자,0
1096,보안관,2017-05-03,2017-11-04,185,1,1,84,0.0,0,20844488409,0,2588628,0,"범죄,코미디",롯데컬처웍스(주)롯데엔터테인먼트,남자,남자,남자,0
1097,보안관,2017-05-03,2017-12-21,232,1,1,106,0.0,0,20844488409,0,2588628,0,"범죄,코미디",롯데컬처웍스(주)롯데엔터테인먼트,남자,남자,남자,0
1098,박열,2017-06-28,2017-06-09,-19,4,4,820,75.4,6180000,6180000,618,618,0,드라마,메가박스중앙(주)플러스엠,남자,남자,남자,0
1099,박열,2017-06-28,2017-06-10,-18,1,1,284,100.0,2272000,8452000,284,902,0,드라마,메가박스중앙(주)플러스엠,남자,남자,남자,0
1100,박열,2017-06-28,2017-06-13,-15,6,6,1226,100.0,7958000,16410000,1226,2128,0,드라마,메가박스중앙(주)플러스엠,남자,남자,남자,0
1101,박열,2017-06-28,2017-06-15,-13,1,1,300,106.3,2233000,18643000,319,2447,0,드라마,메가박스중앙(주)플러스엠,남자,남자,남자,0
1102,박열,2017-06-28,2017-06-16,-12,9,9,1619,50.2,7363500,26006500,812,3259,0,드라마,메가박스중앙(주)플러스엠,남자,남자,남자,0
1103,박열,2017-06-28,2017-06-17,-11,15,14,3590,86.7,26563600,52570100,3112,6371,0,드라마,메가박스중앙(주)플러스엠,남자,남자,남자,0
1104,박열,2017-06-28,2017-06-18,-10,17,17,3923,69.8,24932900,77503000,2737,9108,0,드라마,메가박스중앙(주)플러스엠,남자,남자,남자,0
1105,박열,2017-06-28,2017-06-19,-9,5,5,1619,81.7,6615000,84118000,1323,10431,0,드라마,메가박스중앙(주)플러스엠,남자,남자,남자,0
1106,박열,2017-06-28,2017-06-20,-8,29,29,5306,91.3,37896000,122014000,4842,15273,0,드라마,메가박스중앙(주)플러스엠,남자,남자,남자,0
1107,박열,2017-06-28,2017-06-22,-6,1,1,82,100.0,410000,122424000,82,15355,0,드라마,메가박스중앙(주)플러스엠,남자,남자,남자,0
1108,박열,2017-06-28,2017-06-23,-5,5,3,708,82.2,5614500,128038500,582,15937,0,드라마,메가박스중앙(주)플러스엠,남자,남자,남자,0
1109,박열,2017-06-28,2017-06-26,-2,1,1,180,100.0,1080000,129118500,180,16117,0,드라마,메가박스중앙(주)플러스엠,남자,남자,남자,0
1110,박열,2017-06-28,2017-06-27,-1,25,25,4728,64.7,28321800,157440300,3058,19175,0,드라마,메가박스중앙(주)플러스엠,남자,남자,남자,0
1111,박열,2017-06-28,2017-06-28,0,4191,917,725192,27.9,1184873200,1342313500,201987,221162,0,드라마,메가박스중앙(주)플러스엠,남자,남자,남자,0
1112,박열,2017-06-28,2017-06-29,1,4495,995,777379,18.2,1028040500,2370354000,141299,362461,0,드라마,메가박스중앙(주)플러스엠,남자,남자,남자,0
1113,박열,2017-06-28,2017-06-30,2,4954,1066,874016,19.9,1400110126,3770464126,174136,536597,0,드라마,메가박스중앙(주)플러스엠,남자,남자,남자,0
1114,박열,2017-06-28,2017-07-01,3,5812,1176,1084105,30.5,2746194244,6516658370,330776,867373,0,드라마,메가박스중앙(주)플러스엠,남자,남자,남자,0
1115,박열,2017-06-28,2017-07-02,4,5734,1172,1074594,29.1,2601598600,9118256970,313188,1180561,0,드라마,메가박스중앙(주)플러스엠,남자,남자,남자,0
1116,박열,2017-06-28,2017-07-03,5,5350,1089,999164,11.3,836172000,9954428970,113352,1293913,0,드라마,메가박스중앙(주)플러스엠,남자,남자,남자,0
1117,박열,2017-06-28,2017-07-04,6,5343,1102,995810,10.5,765695800,10720124770,104154,1398067,0,드라마,메가박스중앙(주)플러스엠,남자,남자,남자,0
1118,박열,2017-06-28,2017-07-05,7,3228,743,439350,13.6,431482500,11151607270,59576,1457643,0,드라마,메가박스중앙(주)플러스엠,남자,남자,남자,0
1119,박열,2017-06-28,2017-07-06,8,3182,756,430581,13.1,405622100,11557229370,56290,1513933,0,드라마,메가박스중앙(주)플러스엠,남자,남자,남자,0
1120,박열,2017-06-28,2017-07-07,9,3185,747,426986,17.3,586398568,12143627938,73706,1587639,0,드라마,메가박스중앙(주)플러스엠,남자,남자,남자,0
1121,박열,2017-06-28,2017-07-08,10,2897,708,385492,35.4,1113682758,13257310696,136469,1724108,0,드라마,메가박스중앙(주)플러스엠,남자,남자,남자,0
1122,박열,2017-06-28,2017-07-09,11,2775,686,369765,32.0,958855700,14216166396,118132,1842240,0,드라마,메가박스중앙(주)플러스엠,남자,남자,남자,0
1123,박열,2017-06-28,2017-07-10,12,2941,691,382260,11.4,313715800,14529882196,43647,1885887,0,드라마,메가박스중앙(주)플러스엠,남자,남자,남자,0
1124,박열,2017-06-28,2017-07-11,13,2904,710,378032,12.0,322814100,14852696296,45160,1931047,0,드라마,메가박스중앙(주)플러스엠,남자,남자,남자,0
1125,박열,2017-06-28,2017-07-12,14,2601,653,335231,11.7,275712300,15128408596,39140,1970187,0,드라마,메가박스중앙(주)플러스엠,남자,남자,남자,0
1126,박열,2017-06-28,2017-07-13,15,2139,594,281190,12.6,250446100,15378854696,35493,2005680,0,드라마,메가박스중앙(주)플러스엠,남자,남자,남자,0
1127,박열,2017-06-28,2017-07-14,16,2223,630,287619,16.0,354964342,15733819038,45994,2051674,0,드라마,메가박스중앙(주)플러스엠,남자,남자,남자,0
1128,박열,2017-06-28,2017-07-15,17,2025,638,262548,32.6,688937257,16422756295,85482,2137156,0,드라마,메가박스중앙(주)플러스엠,남자,남자,남자,0
1129,박열,2017-06-28,2017-07-16,18,1948,620,254015,29.6,607606300,17030362595,75059,2212215,0,드라마,메가박스중앙(주)플러스엠,남자,남자,남자,0
1130,박열,2017-06-28,2017-07-17,19,2100,577,271368,10.3,200598000,17230960595,27965,2240180,0,드라마,메가박스중앙(주)플러스엠,남자,남자,남자,0
1131,박열,2017-06-28,2017-07-18,20,2074,602,267613,9.8,185874100,17416834695,26207,2266387,0,드라마,메가박스중앙(주)플러스엠,남자,남자,남자,0
1132,박열,2017-06-28,2017-07-19,21,1847,557,238250,9.8,165207000,17582041695,23249,2289636,0,드라마,메가박스중앙(주)플러스엠,남자,남자,남자,0
1133,박열,2017-06-28,2017-07-20,22,832,389,99673,11.2,76589300,17658630995,11184,2300820,0,드라마,메가박스중앙(주)플러스엠,남자,남자,남자,0
1134,박열,2017-06-28,2017-07-21,23,793,385,96452,11.9,88706400,17747337395,11516,2312336,0,드라마,메가박스중앙(주)플러스엠,남자,남자,남자,0
1135,박열,2017-06-28,2017-07-22,24,611,334,72130,20.0,116492300,17863829695,14396,2326732,0,드라마,메가박스중앙(주)플러스엠,남자,남자,남자,0
1136,박열,2017-06-28,2017-07-23,25,575,325,68794,17.7,98425800,17962255495,12139,2338871,0,드라마,메가박스중앙(주)플러스엠,남자,남자,남자,0
1137,박열,2017-06-28,2017-07-24,26,695,351,83680,8.1,48480200,18010735695,6788,2345659,0,드라마,메가박스중앙(주)플러스엠,남자,남자,남자,0
1138,박열,2017-06-28,2017-07-25,27,689,341,82516,8.3,47371100,18058106795,6838,2352497,0,드라마,메가박스중앙(주)플러스엠,남자,남자,남자,0
1139,박열,2017-06-28,2017-07-26,28,19,17,2308,42.9,4351000,18062457795,989,2353486,0,드라마,메가박스중앙(주)플러스엠,남자,남자,남자,0
1140,박열,2017-06-28,2017-07-27,29,14,12,1611,22.2,1785500,18064243295,358,2353844,0,드라마,메가박스중앙(주)플러스엠,남자,남자,남자,0
1141,박열,2017-06-28,2017-07-28,30,9,7,1059,17.1,1048500,18065291795,181,2354025,0,드라마,메가박스중앙(주)플러스엠,남자,남자,남자,0
1142,박열,2017-06-28,2017-07-29,31,11,8,1237,14.2,1270000,18066561795,175,2354200,0,드라마,메가박스중앙(주)플러스엠,남자,남자,남자,0
1143,박열,2017-06-28,2017-07-30,32,8,6,928,14.1,1093000,18067654795,131,2354331,0,드라마,메가박스중앙(주)플러스엠,남자,남자,남자,0
1144,박열,2017-06-28,2017-07-31,33,9,7,1032,13.3,821000,18068475795,137,2354468,0,드라마,메가박스중앙(주)플러스엠,남자,남자,남자,0
1145,박열,2017-06-28,2017-08-01,34,8,6,726,21.6,1089000,18069564795,157,2354625,0,드라마,메가박스중앙(주)플러스엠,남자,남자,남자,0
1146,박열,2017-06-28,2017-08-02,35,20,20,3022,33.1,5000000,18074564795,1000,2355625,0,드라마,메가박스중앙(주)플러스엠,남자,남자,남자,0
1147,박열,2017-06-28,2017-08-03,36,22,22,3383,32.3,5475000,18080039795,1093,2356718,0,드라마,메가박스중앙(주)플러스엠,남자,남자,남자,0
1148,박열,2017-06-28,2017-08-04,37,5,5,954,10.5,500000,18080539795,100,2356818,0,드라마,메가박스중앙(주)플러스엠,남자,남자,남자,0
1149,박열,2017-06-28,2017-08-05,38,5,5,1074,9.3,500000,18081039795,100,2356918,0,드라마,메가박스중앙(주)플러스엠,남자,남자,남자,0
1150,박열,2017-06-28,2017-08-06,39,5,5,908,11.0,500000,18081539795,100,2357018,0,드라마,메가박스중앙(주)플러스엠,남자,남자,남자,0
1151,박열,2017-06-28,2017-08-07,40,5,5,799,12.5,500000,18082039795,100,2357118,0,드라마,메가박스중앙(주)플러스엠,남자,남자,남자,0
1152,박열,2017-06-28,2017-08-08,41,5,5,799,12.5,500000,18082539795,100,2357218,0,드라마,메가박스중앙(주)플러스엠,남자,남자,남자,0
1153,박열,2017-06-28,2017-08-09,42,5,5,778,12.9,500000,18083039795,100,2357318,0,드라마,메가박스중앙(주)플러스엠,남자,남자,남자,0
1154,박열,2017-06-28,2017-08-10,43,6,6,1004,17.4,1100000,18084139795,175,2357493,0,드라마,메가박스중앙(주)플러스엠,남자,남자,남자,0
1155,박열,2017-06-28,2017-08-11,44,5,5,886,11.3,500000,18084639795,100,2357593,0,드라마,메가박스중앙(주)플러스엠,남자,남자,남자,0
1156,박열,2017-06-28,2017-08-12,45,5,5,886,11.3,500000,18085139795,100,2357693,0,드라마,메가박스중앙(주)플러스엠,남자,남자,남자,0
1157,박열,2017-06-28,2017-08-13,46,5,5,886,11.3,500000,18085639795,100,2357793,0,드라마,메가박스중앙(주)플러스엠,남자,남자,남자,0
1158,박열,2017-06-28,2017-08-14,47,5,5,886,11.3,500000,18086139795,100,2357893,0,드라마,메가박스중앙(주)플러스엠,남자,남자,남자,0
1159,박열,2017-06-28,2017-08-15,48,5,5,857,11.7,500000,18086639795,100,2357993,0,드라마,메가박스중앙(주)플러스엠,남자,남자,남자,0
1160,박열,2017-06-28,2017-08-16,49,5,5,857,11.7,500000,18087139795,100,2358093,0,드라마,메가박스중앙(주)플러스엠,남자,남자,남자,0
1161,박열,2017-06-28,2017-08-17,50,7,7,943,23.4,1464000,18088603795,221,2358314,0,드라마,메가박스중앙(주)플러스엠,남자,남자,남자,0
1162,박열,2017-06-28,2017-08-18,51,6,6,1011,25.7,1940000,18090543795,260,2358574,0,드라마,메가박스중앙(주)플러스엠,남자,남자,남자,0
1163,박열,2017-06-28,2017-08-19,52,5,5,778,12.9,500000,18091043795,100,2358674,0,드라마,메가박스중앙(주)플러스엠,남자,남자,남자,0
1164,박열,2017-06-28,2017-08-20,53,5,5,778,12.9,500000,18091543795,100,2358774,0,드라마,메가박스중앙(주)플러스엠,남자,남자,남자,0
1165,박열,2017-06-28,2017-08-21,54,5,5,799,12.5,500000,18092043795,100,2358874,0,드라마,메가박스중앙(주)플러스엠,남자,남자,남자,0
1166,박열,2017-06-28,2017-08-22,55,5,5,799,12.5,500000,18092543795,100,2358974,0,드라마,메가박스중앙(주)플러스엠,남자,남자,남자,0
1167,박열,2017-06-28,2017-08-23,56,5,5,726,13.8,500000,18093043795,100,2359074,0,드라마,메가박스중앙(주)플러스엠,남자,남자,남자,0
1168,박열,2017-06-28,2017-08-24,57,5,5,817,12.2,500000,18093543795,100,2359174,0,드라마,메가박스중앙(주)플러스엠,남자,남자,남자,0
1169,박열,2017-06-28,2017-09-01,65,1,1,87,0.0,0,18093543795,0,2359174,0,드라마,메가박스중앙(주)플러스엠,남자,남자,남자,0
1170,박열,2017-06-28,2017-11-04,129,1,1,84,0.0,0,18093543795,0,2359174,0,드라마,메가박스중앙(주)플러스엠,남자,남자,남자,0
1171,박열,2017-06-28,2017-11-15,140,1,1,85,0.0,0,18093543795,0,2359174,0,드라마,메가박스중앙(주)플러스엠,남자,남자,남자,0
1172,박열,2017-06-28,2017-11-20,145,1,1,85,0.0,0,18093543795,0,2359174,0,드라마,메가박스중앙(주)플러스엠,남자,남자,남자,0
1173,박열,2017-06-28,2017-11-21,146,1,1,224,0.0,0,18093543795,0,2359174,0,드라마,메가박스중앙(주)플러스엠,남자,남자,남자,0
1174,박열,2017-06-28,2017-12-07,162,1,1,413,3.6,45000,18093588795,15,2359189,0,드라마,메가박스중앙(주)플러스엠,남자,남자,남자,0
1175,박열,2017-06-28,2017-12-08,163,1,1,413,4.1,51000,18093639795,17,2359206,0,드라마,메가박스중앙(주)플러스엠,남자,남자,남자,0
1176,박열,2017-06-28,2017-12-20,175,1,1,106,0.0,0,18093639795,0,2359206,0,드라마,메가박스중앙(주)플러스엠,남자,남자,남자,0
1177,박열,2017-06-28,2018-04-20,296,1,1,82,81.7,536000,18094175795,67,2359273,0,드라마,메가박스중앙(주)플러스엠,남자,남자,남자,0
1178,박열,2017-06-28,2018-12-06,526,1,1,224,100.0,1120000,18095295795,224,2359497,0,드라마,메가박스중앙(주)플러스엠,남자,남자,남자,0
1179,박열,2017-06-28,2019-02-09,591,1,1,160,31.3,325000,18095620795,50,2359547,0,드라마,메가박스중앙(주)플러스엠,남자,남자,남자,0
1180,박열,2017-06-28,2019-08-05,768,1,1,106,94.3,500000,18096120795,100,2359647,0,드라마,메가박스중앙(주)플러스엠,남자,남자,남자,0
1181,군함도,2017-07-26,2017-07-10,-16,1,1,414,100.0,2890000,2890000,414,414,0,"액션,드라마",씨제이이앤엠(주),남자,남자,남자,0
1182,군함도,2017-07-26,2017-07-17,-9,2,1,608,87.5,4248000,7138000,532,946,0,"액션,드라마",씨제이이앤엠(주),남자,남자,남자,0
1183,군함도,2017-07-26,2017-07-19,-7,10,9,3097,92.4,22896000,30034000,2862,3808,0,"액션,드라마",씨제이이앤엠(주),남자,남자,남자,0
1184,군함도,2017-07-26,2017-07-20,-6,21,19,3942,99.8,24369000,54403000,3934,7742,0,"액션,드라마",씨제이이앤엠(주),남자,남자,남자,0
1185,군함도,2017-07-26,2017-07-21,-5,3,3,554,100.0,5493000,59896000,554,8296,0,"액션,드라마",씨제이이앤엠(주),남자,남자,남자,0
1186,군함도,2017-07-26,2017-07-24,-2,26,26,6154,87.9,56120800,116016800,5412,13708,0,"액션,드라마",씨제이이앤엠(주),남자,남자,남자,0
1187,군함도,2017-07-26,2017-07-25,-1,35,34,8028,98.7,69290000,185306800,7921,21629,0,"액션,드라마",씨제이이앤엠(주),남자,남자,남자,0
1188,군함도,2017-07-26,2017-07-26,0,10182,2027,1838526,52.9,6109565800,6294872600,972161,993790,0,"액션,드라마",씨제이이앤엠(주),남자,남자,남자,0
1189,군함도,2017-07-26,2017-07-27,1,10219,1962,1846388,30.3,4121166500,10416039100,559467,1553257,0,"액션,드라마",씨제이이앤엠(주),남자,남자,남자,0
1190,군함도,2017-07-26,2017-07-28,2,10514,1989,1902787,30.6,4811934126,15227973226,582364,2135621,0,"액션,드라마",씨제이이앤엠(주),남자,남자,남자,0
1191,군함도,2017-07-26,2017-07-29,3,10815,2020,1944048,52.3,8437357914,23665331140,1016790,3152411,0,"액션,드라마",씨제이이앤엠(주),남자,남자,남자,0
1192,군함도,2017-07-26,2017-07-30,4,10361,1986,1869318,49.1,7612135400,31277466540,917669,4070080,0,"액션,드라마",씨제이이앤엠(주),남자,남자,남자,0
1193,군함도,2017-07-26,2017-07-31,5,9730,1841,1765102,26.5,3478438000,34755904540,468140,4538220,0,"액션,드라마",씨제이이앤엠(주),남자,남자,남자,0
1194,군함도,2017-07-26,2017-08-01,6,9518,1848,1726636,23.3,2967903300,37723807840,402094,4940314,0,"액션,드라마",씨제이이앤엠(주),남자,남자,남자,0
1195,군함도,2017-07-26,2017-08-02,7,4924,1109,783811,31.7,1826982300,39550790140,248200,5188514,0,"액션,드라마",씨제이이앤엠(주),남자,남자,남자,0
1196,군함도,2017-07-26,2017-08-03,8,4628,1075,734379,27.1,1462878500,41013668640,199203,5387717,0,"액션,드라마",씨제이이앤엠(주),남자,남자,남자,0
1197,군함도,2017-07-26,2017-08-04,9,4273,1018,672121,27.9,1539234185,42552902825,187684,5575401,0,"액션,드라마",씨제이이앤엠(주),남자,남자,남자,0
1198,군함도,2017-07-26,2017-08-05,10,3704,957,569759,47.5,2245544801,44798447626,270522,5845923,0,"액션,드라마",씨제이이앤엠(주),남자,남자,남자,0
1199,군함도,2017-07-26,2017-08-06,11,3432,922,521852,45.0,1945448300,46743895926,234726,6080649,0,"액션,드라마",씨제이이앤엠(주),남자,남자,남자,0
1200,군함도,2017-07-26,2017-08-07,12,3405,876,499273,19.8,721420900,47465316826,98728,6179377,0,"액션,드라마",씨제이이앤엠(주),남자,남자,남자,0
1201,군함도,2017-07-26,2017-08-08,13,3355,857,491079,17.2,609107300,48074424126,84579,6263956,0,"액션,드라마",씨제이이앤엠(주),남자,남자,남자,0
1202,군함도,2017-07-26,2017-08-09,14,1662,632,205648,23.3,345296000,48419720126,47910,6311866,0,"액션,드라마",씨제이이앤엠(주),남자,남자,남자,0
1203,군함도,2017-07-26,2017-08-10,15,1311,569,163682,23.5,276528400,48696248526,38474,6350340,0,"액션,드라마",씨제이이앤엠(주),남자,남자,남자,0
1204,군함도,2017-07-26,2017-08-11,16,1218,538,150620,21.9,263021017,48959269543,33018,6383358,0,"액션,드라마",씨제이이앤엠(주),남자,남자,남자,0
1205,군함도,2017-07-26,2017-08-12,17,961,501,118065,37.1,359288425,49318557968,43746,6427104,0,"액션,드라마",씨제이이앤엠(주),남자,남자,남자,0
1206,군함도,2017-07-26,2017-08-13,18,904,488,110985,35.0,315933900,49634491868,38889,6465993,0,"액션,드라마",씨제이이앤엠(주),남자,남자,남자,0
1207,군함도,2017-07-26,2017-08-14,19,900,471,109830,28.7,226473400,49860965268,31555,6497548,0,"액션,드라마",씨제이이앤엠(주),남자,남자,남자,0
1208,군함도,2017-07-26,2017-08-15,20,341,255,40839,45.9,147073500,50008038768,18748,6516296,0,"액션,드라마",씨제이이앤엠(주),남자,남자,남자,0
1209,군함도,2017-07-26,2017-08-16,21,368,258,44242,23.3,71443800,50079482568,10301,6526597,0,"액션,드라마",씨제이이앤엠(주),남자,남자,남자,0
1210,군함도,2017-07-26,2017-08-17,22,233,192,29455,26.1,51971300,50131453868,7677,6534274,0,"액션,드라마",씨제이이앤엠(주),남자,남자,남자,0
1211,군함도,2017-07-26,2017-08-18,23,225,187,28404,21.6,46838800,50178292668,6143,6540417,0,"액션,드라마",씨제이이앤엠(주),남자,남자,남자,0
1212,군함도,2017-07-26,2017-08-19,24,190,154,23452,29.2,55246300,50233538968,6849,6547266,0,"액션,드라마",씨제이이앤엠(주),남자,남자,남자,0
1213,군함도,2017-07-26,2017-08-20,25,186,148,22017,32.5,58167500,50291706468,7154,6554420,0,"액션,드라마",씨제이이앤엠(주),남자,남자,남자,0
1214,군함도,2017-07-26,2017-08-21,26,244,174,30251,18.4,37418600,50329125068,5576,6559996,0,"액션,드라마",씨제이이앤엠(주),남자,남자,남자,0
1215,군함도,2017-07-26,2017-08-22,27,248,190,30767,19.9,38597900,50367722968,6131,6566127,0,"액션,드라마",씨제이이앤엠(주),남자,남자,남자,0
1216,군함도,2017-07-26,2017-08-23,28,66,54,7827,26.2,13389500,50381112468,2050,6568177,0,"액션,드라마",씨제이이앤엠(주),남자,남자,남자,0
1217,군함도,2017-07-26,2017-08-24,29,77,71,9531,39.2,18899500,50400011968,3739,6571916,0,"액션,드라마",씨제이이앤엠(주),남자,남자,남자,0
1218,군함도,2017-07-26,2017-08-25,30,52,45,6163,31.2,11876900,50411888868,1922,6573838,0,"액션,드라마",씨제이이앤엠(주),남자,남자,남자,0
1219,군함도,2017-07-26,2017-08-26,31,39,30,4991,30.0,10385200,50422274068,1499,6575337,0,"액션,드라마",씨제이이앤엠(주),남자,남자,남자,0
1220,군함도,2017-07-26,2017-08-27,32,31,22,4067,24.0,8091700,50430365768,975,6576312,0,"액션,드라마",씨제이이앤엠(주),남자,남자,남자,0
1221,군함도,2017-07-26,2017-08-28,33,44,32,5238,14.9,5479700,50435845468,781,6577093,0,"액션,드라마",씨제이이앤엠(주),남자,남자,남자,0
1222,군함도,2017-07-26,2017-08-29,34,41,32,5118,13.2,4853800,50440699268,675,6577768,0,"액션,드라마",씨제이이앤엠(주),남자,남자,남자,0
1223,군함도,2017-07-26,2017-08-30,35,11,10,1622,28.3,2522400,50443221668,459,6578227,0,"액션,드라마",씨제이이앤엠(주),남자,남자,남자,0
1224,군함도,2017-07-26,2017-08-31,36,9,9,1034,48.2,2584500,50445806168,498,6578725,0,"액션,드라마",씨제이이앤엠(주),남자,남자,남자,0
1225,군함도,2017-07-26,2017-09-01,37,7,7,1002,7.4,637000,50446443168,74,6578799,0,"액션,드라마",씨제이이앤엠(주),남자,남자,남자,0
1226,군함도,2017-07-26,2017-09-02,38,6,6,854,9.1,595500,50447038668,78,6578877,0,"액션,드라마",씨제이이앤엠(주),남자,남자,남자,0
1227,군함도,2017-07-26,2017-09-03,39,5,5,554,23.7,1157000,50448195668,131,6579008,0,"액션,드라마",씨제이이앤엠(주),남자,남자,남자,0
1228,군함도,2017-07-26,2017-09-04,40,11,11,1399,45.4,2644000,50450839668,635,6579643,0,"액션,드라마",씨제이이앤엠(주),남자,남자,남자,0
1229,군함도,2017-07-26,2017-09-05,41,6,6,691,4.5,199500,50451039168,31,6579674,0,"액션,드라마",씨제이이앤엠(주),남자,남자,남자,0
1230,군함도,2017-07-26,2017-09-06,42,2,2,154,5.2,60500,50451099668,8,6579682,0,"액션,드라마",씨제이이앤엠(주),남자,남자,남자,0
1231,군함도,2017-07-26,2017-09-07,43,4,4,380,57.4,950000,50452049668,218,6579900,0,"액션,드라마",씨제이이앤엠(주),남자,남자,남자,0
1232,군함도,2017-07-26,2017-09-08,44,21,21,3084,13.5,2630000,50454679668,417,6580317,0,"액션,드라마",씨제이이앤엠(주),남자,남자,남자,0
1233,군함도,2017-07-26,2017-09-09,45,7,7,1661,14.6,1400500,50456080168,243,6580560,0,"액션,드라마",씨제이이앤엠(주),남자,남자,남자,0
1234,군함도,2017-07-26,2017-09-10,46,6,6,1051,9.9,636000,50456716168,104,6580664,0,"액션,드라마",씨제이이앤엠(주),남자,남자,남자,0
1235,군함도,2017-07-26,2017-09-11,47,8,8,1198,9.7,702000,50457418168,116,6580780,0,"액션,드라마",씨제이이앤엠(주),남자,남자,남자,0
1236,군함도,2017-07-26,2017-09-12,48,6,6,914,11.4,624000,50458042168,104,6580884,0,"액션,드라마",씨제이이앤엠(주),남자,남자,남자,0
1237,군함도,2017-07-26,2017-09-13,49,8,8,1192,10.2,741000,50458783168,121,6581005,0,"액션,드라마",씨제이이앤엠(주),남자,남자,남자,0
1238,군함도,2017-07-26,2017-09-14,50,10,10,1721,42.2,3665000,50462448168,727,6581732,0,"액션,드라마",씨제이이앤엠(주),남자,남자,남자,0
1239,군함도,2017-07-26,2017-09-15,51,7,7,1151,12.6,833000,50463281168,145,6581877,0,"액션,드라마",씨제이이앤엠(주),남자,남자,남자,0
1240,군함도,2017-07-26,2017-09-16,52,5,5,866,11.6,600000,50463881168,100,6581977,0,"액션,드라마",씨제이이앤엠(주),남자,남자,남자,0
1241,군함도,2017-07-26,2017-09-17,53,7,7,1379,32.6,3389000,50467270168,449,6582426,0,"액션,드라마",씨제이이앤엠(주),남자,남자,남자,0
1242,군함도,2017-07-26,2017-09-18,54,6,6,936,10.9,610500,50467880668,102,6582528,0,"액션,드라마",씨제이이앤엠(주),남자,남자,남자,0
1243,군함도,2017-07-26,2017-09-19,55,7,7,1204,25.5,1441000,50469321668,307,6582835,0,"액션,드라마",씨제이이앤엠(주),남자,남자,남자,0
1244,군함도,2017-07-26,2017-09-20,56,58,57,10102,74.3,30224000,50499545668,7502,6590337,0,"액션,드라마",씨제이이앤엠(주),남자,남자,남자,0
1245,군함도,2017-07-26,2017-09-21,57,9,9,1351,40.9,2412000,50501957668,552,6590889,0,"액션,드라마",씨제이이앤엠(주),남자,남자,남자,0
1246,군함도,2017-07-26,2017-09-22,58,6,6,901,11.5,622500,50502580168,104,6590993,0,"액션,드라마",씨제이이앤엠(주),남자,남자,남자,0
1247,군함도,2017-07-26,2017-09-23,59,5,5,866,11.6,600000,50503180168,100,6591093,0,"액션,드라마",씨제이이앤엠(주),남자,남자,남자,0
1248,군함도,2017-07-26,2017-09-24,60,5,5,866,11.6,600000,50503780168,100,6591193,0,"액션,드라마",씨제이이앤엠(주),남자,남자,남자,0
1249,군함도,2017-07-26,2017-09-25,61,7,7,998,10.6,643000,50504423168,106,6591299,0,"액션,드라마",씨제이이앤엠(주),남자,남자,남자,0
1250,군함도,2017-07-26,2017-09-26,62,7,7,998,10.5,633000,50505056168,105,6591404,0,"액션,드라마",씨제이이앤엠(주),남자,남자,남자,0
1251,군함도,2017-07-26,2017-09-27,63,7,7,1003,12.2,732000,50505788168,122,6591526,0,"액션,드라마",씨제이이앤엠(주),남자,남자,남자,0
1252,군함도,2017-07-26,2017-09-28,64,5,5,866,11.6,600000,50506388168,100,6591626,0,"액션,드라마",씨제이이앤엠(주),남자,남자,남자,0
1253,군함도,2017-07-26,2017-09-29,65,1,1,104,66.4,345000,50506733168,69,6591695,0,"액션,드라마",씨제이이앤엠(주),남자,남자,남자,0
1254,군함도,2017-07-26,2017-10-01,67,1,1,80,100.0,720000,50507453168,80,6591775,0,"액션,드라마",씨제이이앤엠(주),남자,남자,남자,0
1255,군함도,2017-07-26,2017-10-02,68,1,1,80,100.0,720000,50508173168,80,6591855,0,"액션,드라마",씨제이이앤엠(주),남자,남자,남자,0
1256,군함도,2017-07-26,2017-10-03,69,1,1,80,100.0,720000,50508893168,80,6591935,0,"액션,드라마",씨제이이앤엠(주),남자,남자,남자,0
1257,군함도,2017-07-26,2017-10-04,70,1,1,80,100.0,720000,50509613168,80,6592015,0,"액션,드라마",씨제이이앤엠(주),남자,남자,남자,0
1258,군함도,2017-07-26,2017-10-13,79,1,1,136,100.0,952000,50510565168,136,6592151,0,"액션,드라마",씨제이이앤엠(주),남자,남자,남자,0
1259,군함도,2017-07-26,2017-11-14,111,1,1,85,0.0,0,50510565168,0,6592151,0,"액션,드라마",씨제이이앤엠(주),남자,남자,남자,0
1260,군함도,2017-07-26,2017-11-17,114,1,1,85,0.0,0,50510565168,0,6592151,0,"액션,드라마",씨제이이앤엠(주),남자,남자,남자,0
1261,살인자의 기억법,2017-09-06,2017-07-13,-55,1,1,213,96.2,1902000,1902000,205,205,0,"범죄,스릴러",(주)쇼박스,남자,남자,남자,0
1262,살인자의 기억법,2017-09-06,2017-08-28,-9,3,3,722,100.0,5338000,7240000,722,927,0,"범죄,스릴러",(주)쇼박스,남자,남자,남자,0
1263,살인자의 기억법,2017-09-06,2017-08-30,-7,2,2,469,100.0,2345000,9585000,469,1396,0,"범죄,스릴러",(주)쇼박스,남자,남자,남자,0
1264,살인자의 기억법,2017-09-06,2017-08-31,-6,2,2,499,100.0,4223000,13808000,499,1895,0,"범죄,스릴러",(주)쇼박스,남자,남자,남자,0
1265,살인자의 기억법,2017-09-06,2017-09-04,-2,7,7,2336,100.0,18688000,32496000,2336,4231,0,"범죄,스릴러",(주)쇼박스,남자,남자,남자,0
1266,살인자의 기억법,2017-09-06,2017-09-05,-1,2,1,652,75.0,3912000,36408000,489,4720,0,"범죄,스릴러",(주)쇼박스,남자,남자,남자,0
1267,살인자의 기억법,2017-09-06,2017-09-06,0,4340,884,803047,17.9,1070193300,1106601300,143580,148300,0,"범죄,스릴러",(주)쇼박스,남자,남자,남자,0
1268,살인자의 기억법,2017-09-06,2017-09-07,1,4421,942,820096,17.5,1073134200,2179735500,143225,291525,0,"범죄,스릴러",(주)쇼박스,남자,남자,남자,0
1269,살인자의 기억법,2017-09-06,2017-09-08,2,4724,989,886764,21.2,1562505167,3742240667,187986,479511,0,"범죄,스릴러",(주)쇼박스,남자,남자,남자,0
1270,살인자의 기억법,2017-09-06,2017-09-09,3,5378,1064,1034691,35.7,3105887567,6848128234,369025,848536,0,"범죄,스릴러",(주)쇼박스,남자,남자,남자,0
1271,살인자의 기억법,2017-09-06,2017-09-10,4,5324,1060,1025320,33.4,2892335900,9740464134,342871,1191407,0,"범죄,스릴러",(주)쇼박스,남자,남자,남자,0
1272,살인자의 기억법,2017-09-06,2017-09-11,5,4876,972,915486,13.8,943302200,10683766334,126124,1317531,0,"범죄,스릴러",(주)쇼박스,남자,남자,남자,0
1273,살인자의 기억법,2017-09-06,2017-09-12,6,4857,983,913264,10.9,744052600,11427818934,99727,1417258,0,"범죄,스릴러",(주)쇼박스,남자,남자,남자,0
1274,살인자의 기억법,2017-09-06,2017-09-13,7,4682,1011,862252,10.6,679487100,12107306034,91473,1508731,0,"범죄,스릴러",(주)쇼박스,남자,남자,남자,0
1275,살인자의 기억법,2017-09-06,2017-09-14,8,3491,757,623554,11.4,532477600,12639783634,71206,1579937,0,"범죄,스릴러",(주)쇼박스,남자,남자,남자,0
1276,살인자의 기억법,2017-09-06,2017-09-15,9,3676,813,654773,15.0,815284948,13455068582,98154,1678091,0,"범죄,스릴러",(주)쇼박스,남자,남자,남자,0
1277,살인자의 기억법,2017-09-06,2017-09-16,10,4180,884,774122,26.2,1712022533,15167091115,202507,1880598,0,"범죄,스릴러",(주)쇼박스,남자,남자,남자,0
1278,살인자의 기억법,2017-09-06,2017-09-17,11,4096,882,759076,24.2,1551020000,16718111115,183280,2063878,0,"범죄,스릴러",(주)쇼박스,남자,남자,남자,0
1279,살인자의 기억법,2017-09-06,2017-09-18,12,3835,812,674965,8.6,432114500,17150225615,57917,2121795,0,"범죄,스릴러",(주)쇼박스,남자,남자,남자,0
1280,살인자의 기억법,2017-09-06,2017-09-19,13,3789,803,670245,7.6,380801450,17531027065,51148,2172943,0,"범죄,스릴러",(주)쇼박스,남자,남자,남자,0
1281,살인자의 기억법,2017-09-06,2017-09-20,14,3791,829,668671,7.5,371826400,17902853465,50023,2222966,0,"범죄,스릴러",(주)쇼박스,남자,남자,남자,0
1282,살인자의 기억법,2017-09-06,2017-09-21,15,2599,599,397002,9.1,269825400,18172678865,36073,2259039,0,"범죄,스릴러",(주)쇼박스,남자,남자,남자,0
1283,살인자의 기억법,2017-09-06,2017-09-22,16,2725,622,422542,10.9,384069911,18556748776,46236,2305275,0,"범죄,스릴러",(주)쇼박스,남자,남자,남자,0
1284,살인자의 기억법,2017-09-06,2017-09-23,17,2974,678,471365,18.9,751346016,19308094792,89242,2394517,0,"범죄,스릴러",(주)쇼박스,남자,남자,남자,0
1285,살인자의 기억법,2017-09-06,2017-09-24,18,2913,663,464739,17.0,671566000,19979660792,79082,2473599,0,"범죄,스릴러",(주)쇼박스,남자,남자,남자,0
1286,살인자의 기억법,2017-09-06,2017-09-25,19,2641,626,392754,6.2,181315100,20160975892,24330,2497929,0,"범죄,스릴러",(주)쇼박스,남자,남자,남자,0
1287,살인자의 기억법,2017-09-06,2017-09-26,20,2596,629,386315,6.0,172874600,20333850492,23327,2521256,0,"범죄,스릴러",(주)쇼박스,남자,남자,남자,0
1288,살인자의 기억법,2017-09-06,2017-09-27,21,1237,503,159501,11.1,106254900,20440105392,17697,2538953,0,"범죄,스릴러",(주)쇼박스,남자,남자,남자,0
1289,살인자의 기억법,2017-09-06,2017-09-28,22,1085,461,138920,8.0,81370500,20521475892,11108,2550061,0,"범죄,스릴러",(주)쇼박스,남자,남자,남자,0
1290,살인자의 기억법,2017-09-06,2017-09-29,23,1090,458,137178,13.6,146719500,20668195392,18603,2568664,0,"범죄,스릴러",(주)쇼박스,남자,남자,남자,0
1291,살인자의 기억법,2017-09-06,2017-09-30,24,953,453,117047,21.9,205946100,20874141492,25586,2594250,0,"범죄,스릴러",(주)쇼박스,남자,남자,남자,0
1292,살인자의 기억법,2017-09-06,2017-10-01,25,935,460,116760,24.5,235672700,21109814192,28608,2622858,0,"범죄,스릴러",(주)쇼박스,남자,남자,남자,0
1293,살인자의 기억법,2017-09-06,2017-10-02,26,924,451,114572,22.8,194182700,21303996892,26070,2648928,0,"범죄,스릴러",(주)쇼박스,남자,남자,남자,0
1294,살인자의 기억법,2017-09-06,2017-10-03,27,64,43,7747,19.3,12166800,21316163692,1493,2650421,0,"범죄,스릴러",(주)쇼박스,남자,남자,남자,0
1295,살인자의 기억법,2017-09-06,2017-10-04,28,63,47,7205,23.9,14353300,21330516992,1720,2652141,0,"범죄,스릴러",(주)쇼박스,남자,남자,남자,0
1296,살인자의 기억법,2017-09-06,2017-10-05,29,55,40,6442,19.4,10094600,21340611592,1248,2653389,0,"범죄,스릴러",(주)쇼박스,남자,남자,남자,0
1297,살인자의 기억법,2017-09-06,2017-10-06,30,37,29,4260,22.6,7904800,21348516392,962,2654351,0,"범죄,스릴러",(주)쇼박스,남자,남자,남자,0
1298,살인자의 기억법,2017-09-06,2017-10-07,31,38,30,4894,13.7,5414900,21353931292,670,2655021,0,"범죄,스릴러",(주)쇼박스,남자,남자,남자,0
1299,살인자의 기억법,2017-09-06,2017-10-08,32,36,25,4208,13.5,4542200,21358473492,567,2655588,0,"범죄,스릴러",(주)쇼박스,남자,남자,남자,0
1300,살인자의 기억법,2017-09-06,2017-10-09,33,32,24,3573,8.5,2360000,21360833492,303,2655891,0,"범죄,스릴러",(주)쇼박스,남자,남자,남자,0
1301,살인자의 기억법,2017-09-06,2017-10-10,34,50,38,6251,4.6,1743500,21362576992,287,2656178,0,"범죄,스릴러",(주)쇼박스,남자,남자,남자,0
1302,살인자의 기억법,2017-09-06,2017-10-11,35,51,36,6538,3.6,1722500,21364299492,238,2656416,0,"범죄,스릴러",(주)쇼박스,남자,남자,남자,0
1303,살인자의 기억법,2017-09-06,2017-10-12,36,4,2,448,11.4,239000,21364538492,51,2656467,0,"범죄,스릴러",(주)쇼박스,남자,남자,남자,0
1304,살인자의 기억법,2017-09-06,2017-10-13,37,1,1,68,100.0,408000,21364946492,68,2656535,0,"범죄,스릴러",(주)쇼박스,남자,남자,남자,0
1305,살인자의 기억법,2017-09-06,2017-10-14,38,1,1,72,8.3,54000,21365000492,6,2656541,0,"범죄,스릴러",(주)쇼박스,남자,남자,남자,0
1306,살인자의 기억법,2017-09-06,2017-10-15,39,1,1,72,19.4,103000,21365103492,14,2656555,0,"범죄,스릴러",(주)쇼박스,남자,남자,남자,0
1307,살인자의 기억법,2017-09-06,2017-10-17,41,1,1,72,1.4,5000,21365108492,1,2656556,0,"범죄,스릴러",(주)쇼박스,남자,남자,남자,0
1308,살인자의 기억법,2017-09-06,2017-10-18,42,1,1,72,1.4,9000,21365117492,1,2656557,0,"범죄,스릴러",(주)쇼박스,남자,남자,남자,0
1309,살인자의 기억법,2017-09-06,2017-10-19,43,20,20,3104,12.9,2000000,21367117492,400,2656957,0,"범죄,스릴러",(주)쇼박스,남자,남자,남자,0
1310,살인자의 기억법,2017-09-06,2017-10-20,44,20,20,2920,13.7,2000000,21369117492,400,2657357,0,"범죄,스릴러",(주)쇼박스,남자,남자,남자,0
1311,살인자의 기억법,2017-09-06,2017-10-21,45,5,5,1156,8.7,500000,21369617492,100,2657457,0,"범죄,스릴러",(주)쇼박스,남자,남자,남자,0
1312,살인자의 기억법,2017-09-06,2017-10-22,46,5,5,1156,8.7,500000,21370117492,100,2657557,0,"범죄,스릴러",(주)쇼박스,남자,남자,남자,0
1313,살인자의 기억법,2017-09-06,2017-10-23,47,5,5,1072,9.3,500000,21370617492,100,2657657,0,"범죄,스릴러",(주)쇼박스,남자,남자,남자,0
1314,살인자의 기억법,2017-09-06,2017-10-24,48,5,5,1072,9.3,500000,21371117492,100,2657757,0,"범죄,스릴러",(주)쇼박스,남자,남자,남자,0
1315,살인자의 기억법,2017-09-06,2017-10-25,49,5,5,1014,9.9,500000,21371617492,100,2657857,0,"범죄,스릴러",(주)쇼박스,남자,남자,남자,0
1316,살인자의 기억법,2017-09-06,2017-10-26,50,5,5,1015,9.9,500000,21372117492,100,2657957,0,"범죄,스릴러",(주)쇼박스,남자,남자,남자,0
1317,살인자의 기억법,2017-09-06,2017-10-27,51,5,5,1082,9.2,500000,21372617492,100,2658057,0,"범죄,스릴러",(주)쇼박스,남자,남자,남자,0
1318,살인자의 기억법,2017-09-06,2017-10-28,52,5,5,1174,8.5,500000,21373117492,100,2658157,0,"범죄,스릴러",(주)쇼박스,남자,남자,남자,0
1319,살인자의 기억법,2017-09-06,2017-10-29,53,5,5,1170,8.6,500000,21373617492,100,2658257,0,"범죄,스릴러",(주)쇼박스,남자,남자,남자,0
1320,살인자의 기억법,2017-09-06,2017-10-30,54,5,5,1311,7.6,500000,21374117492,100,2658357,0,"범죄,스릴러",(주)쇼박스,남자,남자,남자,0
1321,살인자의 기억법,2017-09-06,2017-10-31,55,5,5,1094,9.1,500000,21374617492,100,2658457,0,"범죄,스릴러",(주)쇼박스,남자,남자,남자,0
1322,살인자의 기억법,2017-09-06,2017-11-01,56,5,5,1015,9.9,500000,21375117492,100,2658557,0,"범죄,스릴러",(주)쇼박스,남자,남자,남자,0
1323,살인자의 기억법,2017-09-06,2017-11-09,64,1,1,285,10.5,150000,21375267492,30,2658587,0,"범죄,스릴러",(주)쇼박스,남자,남자,남자,0
1324,살인자의 기억법,2017-09-06,2017-12-02,87,1,1,306,0.7,20000,21375287492,2,2658589,0,"범죄,스릴러",(주)쇼박스,남자,남자,남자,0
1325,아이 캔 스피크,2017-09-21,2017-09-06,-15,32,28,7470,99.3,61048000,61048000,7414,7414,2,코미디,"롯데쇼핑㈜롯데엔터테인먼트,(주)리틀빅픽쳐스",남자,여자,여자,2
1326,아이 캔 스피크,2017-09-21,2017-09-09,-12,10,10,2525,100.0,25124000,86172000,2525,9939,2,코미디,"롯데쇼핑㈜롯데엔터테인먼트,(주)리틀빅픽쳐스",남자,여자,여자,2
1327,아이 캔 스피크,2017-09-21,2017-09-11,-10,13,13,2350,100.0,18800000,104972000,2350,12289,2,코미디,"롯데쇼핑㈜롯데엔터테인먼트,(주)리틀빅픽쳐스",남자,여자,여자,2
1328,아이 캔 스피크,2017-09-21,2017-09-12,-9,6,6,1052,100.4,8448000,113420000,1056,13345,2,코미디,"롯데쇼핑㈜롯데엔터테인먼트,(주)리틀빅픽쳐스",남자,여자,여자,2
1329,아이 캔 스피크,2017-09-21,2017-09-13,-8,10,9,2452,73.9,14488000,127908000,1811,15156,2,코미디,"롯데쇼핑㈜롯데엔터테인먼트,(주)리틀빅픽쳐스",남자,여자,여자,2
1330,아이 캔 스피크,2017-09-21,2017-09-14,-7,12,12,2334,99.6,18600000,146508000,2325,17481,2,코미디,"롯데쇼핑㈜롯데엔터테인먼트,(주)리틀빅픽쳐스",남자,여자,여자,2
1331,아이 캔 스피크,2017-09-21,2017-09-15,-6,1,1,72,98.6,568000,147076000,71,17552,2,코미디,"롯데쇼핑㈜롯데엔터테인먼트,(주)리틀빅픽쳐스",남자,여자,여자,2
1332,아이 캔 스피크,2017-09-21,2017-09-16,-5,10,10,2354,80.5,16883200,163959200,1896,19448,2,코미디,"롯데쇼핑㈜롯데엔터테인먼트,(주)리틀빅픽쳐스",남자,여자,여자,2
1333,아이 캔 스피크,2017-09-21,2017-09-17,-4,10,10,2516,70.4,16146200,180105400,1770,21218,2,코미디,"롯데쇼핑㈜롯데엔터테인먼트,(주)리틀빅픽쳐스",남자,여자,여자,2
1334,아이 캔 스피크,2017-09-21,2017-09-18,-3,17,17,3413,100.0,27664000,207769400,3413,24631,2,코미디,"롯데쇼핑㈜롯데엔터테인먼트,(주)리틀빅픽쳐스",남자,여자,여자,2
1335,아이 캔 스피크,2017-09-21,2017-09-19,-2,37,37,7501,85.0,47205000,254974400,6378,31009,2,코미디,"롯데쇼핑㈜롯데엔터테인먼트,(주)리틀빅픽쳐스",남자,여자,여자,2
1336,아이 캔 스피크,2017-09-21,2017-09-20,-1,4,4,888,56.6,3756000,258730400,503,31512,2,코미디,"롯데쇼핑㈜롯데엔터테인먼트,(주)리틀빅픽쳐스",남자,여자,여자,2
1337,아이 캔 스피크,2017-09-21,2017-09-21,0,5100,1004,960608,9.1,634048900,892779300,87136,118648,2,코미디,"롯데쇼핑㈜롯데엔터테인먼트,(주)리틀빅픽쳐스",남자,여자,여자,2
1338,아이 캔 스피크,2017-09-21,2017-09-22,1,5342,1026,1002851,12.1,977151436,1869930736,121355,240003,2,코미디,"롯데쇼핑㈜롯데엔터테인먼트,(주)리틀빅픽쳐스",남자,여자,여자,2
1339,아이 캔 스피크,2017-09-21,2017-09-23,2,6123,1140,1184235,20.5,1998688724,3868619460,242986,482989,2,코미디,"롯데쇼핑㈜롯데엔터테인먼트,(주)리틀빅픽쳐스",남자,여자,여자,2
1340,아이 캔 스피크,2017-09-21,2017-09-24,3,5987,1122,1160791,21.0,1999592600,5868212060,243340,726329,2,코미디,"롯데쇼핑㈜롯데엔터테인먼트,(주)리틀빅픽쳐스",남자,여자,여자,2
1341,아이 캔 스피크,2017-09-21,2017-09-25,4,5388,1039,1010464,8.6,634330300,6502542360,87182,813511,2,코미디,"롯데쇼핑㈜롯데엔터테인먼트,(주)리틀빅픽쳐스",남자,여자,여자,2
1342,아이 캔 스피크,2017-09-21,2017-09-26,5,5411,1075,1007226,8.7,627873600,7130415960,87456,900967,2,코미디,"롯데쇼핑㈜롯데엔터테인먼트,(주)리틀빅픽쳐스",남자,여자,여자,2
1343,아이 캔 스피크,2017-09-21,2017-09-27,6,3952,934,588401,21.5,728527400,7858943360,126570,1027537,2,코미디,"롯데쇼핑㈜롯데엔터테인먼트,(주)리틀빅픽쳐스",남자,여자,여자,2
1344,아이 캔 스피크,2017-09-21,2017-09-28,7,3969,887,586382,12.4,518518100,8377461460,72396,1099933,2,코미디,"롯데쇼핑㈜롯데엔터테인먼트,(주)리틀빅픽쳐스",남자,여자,여자,2
1345,아이 캔 스피크,2017-09-21,2017-09-29,8,4219,937,626592,19.1,928975874,9306437334,119762,1219695,2,코미디,"롯데쇼핑㈜롯데엔터테인먼트,(주)리틀빅픽쳐스",남자,여자,여자,2
1346,아이 캔 스피크,2017-09-21,2017-09-30,9,4303,901,641297,31.6,1614206780,10920644114,202900,1422595,2,코미디,"롯데쇼핑㈜롯데엔터테인먼트,(주)리틀빅픽쳐스",남자,여자,여자,2
1347,아이 캔 스피크,2017-09-21,2017-10-01,10,4262,897,636641,35.6,1848068600,12768712714,226757,1649352,2,코미디,"롯데쇼핑㈜롯데엔터테인먼트,(주)리틀빅픽쳐스",남자,여자,여자,2
1348,아이 캔 스피크,2017-09-21,2017-10-02,11,4352,921,649214,33.8,1596664100,14365376814,219081,1868433,2,코미디,"롯데쇼핑㈜롯데엔터테인먼트,(주)리틀빅픽쳐스",남자,여자,여자,2
1349,아이 캔 스피크,2017-09-21,2017-10-03,12,2592,717,351701,39.8,1155429400,15520806214,139816,2008249,2,코미디,"롯데쇼핑㈜롯데엔터테인먼트,(주)리틀빅픽쳐스",남자,여자,여자,2
1350,아이 캔 스피크,2017-09-21,2017-10-04,13,2691,774,374814,51.9,1622726150,17143532364,194624,2202873,2,코미디,"롯데쇼핑㈜롯데엔터테인먼트,(주)리틀빅픽쳐스",남자,여자,여자,2
1351,아이 캔 스피크,2017-09-21,2017-10-05,14,2806,806,397739,51.1,1656946500,18800478864,203407,2406280,2,코미디,"롯데쇼핑㈜롯데엔터테인먼트,(주)리틀빅픽쳐스",남자,여자,여자,2
1352,아이 캔 스피크,2017-09-21,2017-10-06,15,2658,790,375931,51.5,1551230679,20351709543,193628,2599908,2,코미디,"롯데쇼핑㈜롯데엔터테인먼트,(주)리틀빅픽쳐스",남자,여자,여자,2
1353,아이 캔 스피크,2017-09-21,2017-10-07,16,2566,783,358883,39.8,1147597343,21499306886,142788,2742696,2,코미디,"롯데쇼핑㈜롯데엔터테인먼트,(주)리틀빅픽쳐스",남자,여자,여자,2
1354,아이 캔 스피크,2017-09-21,2017-10-08,17,2457,756,337210,37.6,1027218200,22526525086,126906,2869602,2,코미디,"롯데쇼핑㈜롯데엔터테인먼트,(주)리틀빅픽쳐스",남자,여자,여자,2
1355,아이 캔 스피크,2017-09-21,2017-10-09,18,2349,717,320049,35.0,879636800,23406161886,111997,2981599,2,코미디,"롯데쇼핑㈜롯데엔터테인먼트,(주)리틀빅픽쳐스",남자,여자,여자,2
1356,아이 캔 스피크,2017-09-21,2017-10-10,19,2166,614,281482,7.4,147187300,23553349186,20777,3002376,2,코미디,"롯데쇼핑㈜롯데엔터테인먼트,(주)리틀빅픽쳐스",남자,여자,여자,2
1357,아이 캔 스피크,2017-09-21,2017-10-11,20,2168,593,279566,9.2,180454900,23733804086,25723,3028099,2,코미디,"롯데쇼핑㈜롯데엔터테인먼트,(주)리틀빅픽쳐스",남자,여자,여자,2
1358,아이 캔 스피크,2017-09-21,2017-10-12,21,1189,475,145337,11.5,114015300,23847819386,16737,3044836,2,코미디,"롯데쇼핑㈜롯데엔터테인먼트,(주)리틀빅픽쳐스",남자,여자,여자,2
1359,아이 캔 스피크,2017-09-21,2017-10-13,22,1234,517,150924,15.6,175094400,24022913786,23524,3068360,2,코미디,"롯데쇼핑㈜롯데엔터테인먼트,(주)리틀빅픽쳐스",남자,여자,여자,2
1360,아이 캔 스피크,2017-09-21,2017-10-14,23,1201,489,151508,25.2,308027600,24330941386,38123,3106483,2,코미디,"롯데쇼핑㈜롯데엔터테인먼트,(주)리틀빅픽쳐스",남자,여자,여자,2
1361,아이 캔 스피크,2017-09-21,2017-10-15,24,1159,482,145253,23.9,280653900,24611595286,34703,3141186,2,코미디,"롯데쇼핑㈜롯데엔터테인먼트,(주)리틀빅픽쳐스",남자,여자,여자,2
1362,아이 캔 스피크,2017-09-21,2017-10-16,25,1220,475,152663,8.5,90413900,24702009186,12953,3154139,2,코미디,"롯데쇼핑㈜롯데엔터테인먼트,(주)리틀빅픽쳐스",남자,여자,여자,2
1363,아이 캔 스피크,2017-09-21,2017-10-17,26,1206,492,152753,9.4,98103700,24800112886,14416,3168555,2,코미디,"롯데쇼핑㈜롯데엔터테인먼트,(주)리틀빅픽쳐스",남자,여자,여자,2
1364,아이 캔 스피크,2017-09-21,2017-10-18,27,1232,498,157294,10.5,111743900,24911856786,16538,3185093,2,코미디,"롯데쇼핑㈜롯데엔터테인먼트,(주)리틀빅픽쳐스",남자,여자,여자,2
1365,아이 캔 스피크,2017-09-21,2017-10-19,28,380,242,48811,16.2,51945700,24963802486,7925,3193018,2,코미디,"롯데쇼핑㈜롯데엔터테인먼트,(주)리틀빅픽쳐스",남자,여자,여자,2
1366,아이 캔 스피크,2017-09-21,2017-10-20,29,385,238,48939,16.4,58002100,25021804586,8040,3201058,2,코미디,"롯데쇼핑㈜롯데엔터테인먼트,(주)리틀빅픽쳐스",남자,여자,여자,2
1367,아이 캔 스피크,2017-09-21,2017-10-21,30,400,248,50279,22.6,90341000,25112145586,11360,3212418,2,코미디,"롯데쇼핑㈜롯데엔터테인먼트,(주)리틀빅픽쳐스",남자,여자,여자,2
1368,아이 캔 스피크,2017-09-21,2017-10-22,31,400,258,51057,21.3,86936200,25199081786,10882,3223300,2,코미디,"롯데쇼핑㈜롯데엔터테인먼트,(주)리틀빅픽쳐스",남자,여자,여자,2
1369,아이 캔 스피크,2017-09-21,2017-10-23,32,409,249,53279,9.8,34311000,25233392786,5215,3228515,2,코미디,"롯데쇼핑㈜롯데엔터테인먼트,(주)리틀빅픽쳐스",남자,여자,여자,2
1370,아이 캔 스피크,2017-09-21,2017-10-24,33,412,247,52272,8.8,31535800,25264928586,4623,3233138,2,코미디,"롯데쇼핑㈜롯데엔터테인먼트,(주)리틀빅픽쳐스",남자,여자,여자,2
1371,아이 캔 스피크,2017-09-21,2017-10-25,34,162,140,24629,56.9,61819000,25326747586,14017,3247155,2,코미디,"롯데쇼핑㈜롯데엔터테인먼트,(주)리틀빅픽쳐스",남자,여자,여자,2
1372,아이 캔 스피크,2017-09-21,2017-10-26,35,122,98,16407,26.9,25795800,25352543386,4406,3251561,2,코미디,"롯데쇼핑㈜롯데엔터테인먼트,(주)리틀빅픽쳐스",남자,여자,여자,2
1373,아이 캔 스피크,2017-09-21,2017-10-27,36,107,82,13837,16.9,17164700,25369708086,2336,3253897,2,코미디,"롯데쇼핑㈜롯데엔터테인먼트,(주)리틀빅픽쳐스",남자,여자,여자,2
1374,아이 캔 스피크,2017-09-21,2017-10-28,37,83,66,10733,20.1,16793700,25386501786,2157,3256054,2,코미디,"롯데쇼핑㈜롯데엔터테인먼트,(주)리틀빅픽쳐스",남자,여자,여자,2
1375,아이 캔 스피크,2017-09-21,2017-10-29,38,80,63,10640,20.7,17079600,25403581386,2206,3258260,2,코미디,"롯데쇼핑㈜롯데엔터테인먼트,(주)리틀빅픽쳐스",남자,여자,여자,2
1376,아이 캔 스피크,2017-09-21,2017-10-30,39,120,89,16218,14.4,13354600,25416935986,2335,3260595,2,코미디,"롯데쇼핑㈜롯데엔터테인먼트,(주)리틀빅픽쳐스",남자,여자,여자,2
1377,아이 캔 스피크,2017-09-21,2017-10-31,40,112,87,14983,12.5,12263800,25429199786,1876,3262471,2,코미디,"롯데쇼핑㈜롯데엔터테인먼트,(주)리틀빅픽쳐스",남자,여자,여자,2
1378,아이 캔 스피크,2017-09-21,2017-11-01,41,112,80,15284,15.5,15255900,25444455686,2365,3264836,2,코미디,"롯데쇼핑㈜롯데엔터테인먼트,(주)리틀빅픽쳐스",남자,여자,여자,2
1379,아이 캔 스피크,2017-09-21,2017-11-02,42,21,21,2663,49.8,6831000,25451286686,1326,3266162,2,코미디,"롯데쇼핑㈜롯데엔터테인먼트,(주)리틀빅픽쳐스",남자,여자,여자,2
1380,아이 캔 스피크,2017-09-21,2017-11-03,43,20,18,2139,23.7,3696500,25454983186,507,3266669,2,코미디,"롯데쇼핑㈜롯데엔터테인먼트,(주)리틀빅픽쳐스",남자,여자,여자,2
1381,아이 캔 스피크,2017-09-21,2017-11-04,44,13,12,1345,15.3,1635500,25456618686,206,3266875,2,코미디,"롯데쇼핑㈜롯데엔터테인먼트,(주)리틀빅픽쳐스",남자,여자,여자,2
1382,아이 캔 스피크,2017-09-21,2017-11-05,45,13,12,1359,14.4,1563000,25458181686,195,3267070,2,코미디,"롯데쇼핑㈜롯데엔터테인먼트,(주)리틀빅픽쳐스",남자,여자,여자,2
1383,아이 캔 스피크,2017-09-21,2017-11-06,46,20,19,2487,44.9,5523000,25463704686,1116,3268186,2,코미디,"롯데쇼핑㈜롯데엔터테인먼트,(주)리틀빅픽쳐스",남자,여자,여자,2
1384,아이 캔 스피크,2017-09-21,2017-11-07,47,17,17,2131,38.2,4287000,25467991686,813,3268999,2,코미디,"롯데쇼핑㈜롯데엔터테인먼트,(주)리틀빅픽쳐스",남자,여자,여자,2
1385,아이 캔 스피크,2017-09-21,2017-11-08,48,16,15,1794,35.5,3561500,25471553186,636,3269635,2,코미디,"롯데쇼핑㈜롯데엔터테인먼트,(주)리틀빅픽쳐스",남자,여자,여자,2
1386,아이 캔 스피크,2017-09-21,2017-11-09,49,9,9,1236,49.0,3276000,25474829186,606,3270241,2,코미디,"롯데쇼핑㈜롯데엔터테인먼트,(주)리틀빅픽쳐스",남자,여자,여자,2
1387,아이 캔 스피크,2017-09-21,2017-11-10,50,7,6,772,46.8,1870500,25476699686,361,3270602,2,코미디,"롯데쇼핑㈜롯데엔터테인먼트,(주)리틀빅픽쳐스",남자,여자,여자,2
1388,아이 캔 스피크,2017-09-21,2017-11-11,51,5,5,739,19.2,956000,25477655686,142,3270744,2,코미디,"롯데쇼핑㈜롯데엔터테인먼트,(주)리틀빅픽쳐스",남자,여자,여자,2
1389,아이 캔 스피크,2017-09-21,2017-11-12,52,2,2,257,13.6,259000,25477914686,35,3270779,2,코미디,"롯데쇼핑㈜롯데엔터테인먼트,(주)리틀빅픽쳐스",남자,여자,여자,2
1390,아이 캔 스피크,2017-09-21,2017-11-13,53,8,6,695,13.7,548000,25478462686,95,3270874,2,코미디,"롯데쇼핑㈜롯데엔터테인먼트,(주)리틀빅픽쳐스",남자,여자,여자,2
1391,아이 캔 스피크,2017-09-21,2017-11-14,54,10,7,820,12.6,646500,25479109186,103,3270977,2,코미디,"롯데쇼핑㈜롯데엔터테인먼트,(주)리틀빅픽쳐스",남자,여자,여자,2
1392,아이 캔 스피크,2017-09-21,2017-11-15,55,4,4,360,72.2,1603000,25480712186,260,3271237,2,코미디,"롯데쇼핑㈜롯데엔터테인먼트,(주)리틀빅픽쳐스",남자,여자,여자,2
1393,아이 캔 스피크,2017-09-21,2017-11-16,56,1,1,104,4.8,33000,25480745186,5,3271242,2,코미디,"롯데쇼핑㈜롯데엔터테인먼트,(주)리틀빅픽쳐스",남자,여자,여자,2
1394,아이 캔 스피크,2017-09-21,2017-11-17,57,5,5,572,49.1,1458000,25482203186,281,3271523,2,코미디,"롯데쇼핑㈜롯데엔터테인먼트,(주)리틀빅픽쳐스",남자,여자,여자,2
1395,아이 캔 스피크,2017-09-21,2017-11-18,58,3,3,403,76.2,1690000,25483893186,307,3271830,2,코미디,"롯데쇼핑㈜롯데엔터테인먼트,(주)리틀빅픽쳐스",남자,여자,여자,2
1396,아이 캔 스피크,2017-09-21,2017-11-20,60,2,1,80,8.8,44000,25483937186,7,3271837,2,코미디,"롯데쇼핑㈜롯데엔터테인먼트,(주)리틀빅픽쳐스",남자,여자,여자,2
1397,아이 캔 스피크,2017-09-21,2017-11-21,61,2,2,207,58.5,605000,25484542186,121,3271958,2,코미디,"롯데쇼핑㈜롯데엔터테인먼트,(주)리틀빅픽쳐스",남자,여자,여자,2
1398,아이 캔 스피크,2017-09-21,2017-11-23,63,2,2,268,100.0,1230000,25485772186,268,3272226,2,코미디,"롯데쇼핑㈜롯데엔터테인먼트,(주)리틀빅픽쳐스",남자,여자,여자,2
1399,아이 캔 스피크,2017-09-21,2017-11-24,64,1,1,135,100.0,1080000,25486852186,135,3272361,2,코미디,"롯데쇼핑㈜롯데엔터테인먼트,(주)리틀빅픽쳐스",남자,여자,여자,2
1400,아이 캔 스피크,2017-09-21,2017-11-27,67,1,1,40,12.5,32000,25486884186,5,3272366,2,코미디,"롯데쇼핑㈜롯데엔터테인먼트,(주)리틀빅픽쳐스",남자,여자,여자,2
1401,아이 캔 스피크,2017-09-21,2017-11-28,68,5,4,269,69.1,1079000,25487963186,186,3272552,2,코미디,"롯데쇼핑㈜롯데엔터테인먼트,(주)리틀빅픽쳐스",남자,여자,여자,2
1402,아이 캔 스피크,2017-09-21,2017-11-29,69,7,7,908,77.1,3950000,25491913186,700,3273252,2,코미디,"롯데쇼핑㈜롯데엔터테인먼트,(주)리틀빅픽쳐스",남자,여자,여자,2
1403,아이 캔 스피크,2017-09-21,2017-11-30,70,2,2,307,100.0,1528000,25493441186,307,3273559,2,코미디,"롯데쇼핑㈜롯데엔터테인먼트,(주)리틀빅픽쳐스",남자,여자,여자,2
1404,아이 캔 스피크,2017-09-21,2017-12-01,71,2,2,193,100.0,1251000,25494692186,193,3273752,2,코미디,"롯데쇼핑㈜롯데엔터테인먼트,(주)리틀빅픽쳐스",남자,여자,여자,2
1405,아이 캔 스피크,2017-09-21,2017-12-02,72,2,2,598,100.2,5873000,25500565186,599,3274351,2,코미디,"롯데쇼핑㈜롯데엔터테인먼트,(주)리틀빅픽쳐스",남자,여자,여자,2
1406,아이 캔 스피크,2017-09-21,2017-12-03,73,2,2,106,88.7,555000,25501120186,94,3274445,2,코미디,"롯데쇼핑㈜롯데엔터테인먼트,(주)리틀빅픽쳐스",남자,여자,여자,2
1407,아이 캔 스피크,2017-09-21,2017-12-04,74,2,1,80,27.5,144000,25501264186,22,3274467,2,코미디,"롯데쇼핑㈜롯데엔터테인먼트,(주)리틀빅픽쳐스",남자,여자,여자,2
1408,아이 캔 스피크,2017-09-21,2017-12-05,75,4,4,341,80.4,1361000,25502625186,274,3274741,2,코미디,"롯데쇼핑㈜롯데엔터테인먼트,(주)리틀빅픽쳐스",남자,여자,여자,2
1409,아이 캔 스피크,2017-09-21,2017-12-06,76,10,9,884,83.8,3802000,25506427186,741,3275482,2,코미디,"롯데쇼핑㈜롯데엔터테인먼트,(주)리틀빅픽쳐스",남자,여자,여자,2
1410,아이 캔 스피크,2017-09-21,2017-12-07,77,1,1,289,69.2,1000000,25507427186,200,3275682,2,코미디,"롯데쇼핑㈜롯데엔터테인먼트,(주)리틀빅픽쳐스",남자,여자,여자,2
1411,아이 캔 스피크,2017-09-21,2017-12-08,78,3,3,630,40.3,1102000,25508529186,254,3275936,2,코미디,"롯데쇼핑㈜롯데엔터테인먼트,(주)리틀빅픽쳐스",남자,여자,여자,2
1412,아이 캔 스피크,2017-09-21,2017-12-09,79,1,1,413,7.5,93000,25508622186,31,3275967,2,코미디,"롯데쇼핑㈜롯데엔터테인먼트,(주)리틀빅픽쳐스",남자,여자,여자,2
1413,아이 캔 스피크,2017-09-21,2017-12-11,81,5,5,677,61.3,2427000,25511049186,415,3276382,2,코미디,"롯데쇼핑㈜롯데엔터테인먼트,(주)리틀빅픽쳐스",남자,여자,여자,2
1414,아이 캔 스피크,2017-09-21,2017-12-12,82,12,12,1902,84.4,8558000,25519607186,1605,3277987,2,코미디,"롯데쇼핑㈜롯데엔터테인먼트,(주)리틀빅픽쳐스",남자,여자,여자,2
1415,아이 캔 스피크,2017-09-21,2017-12-13,83,6,6,775,29.7,1251000,25520858186,230,3278217,2,코미디,"롯데쇼핑㈜롯데엔터테인먼트,(주)리틀빅픽쳐스",남자,여자,여자,2
1416,아이 캔 스피크,2017-09-21,2017-12-14,84,3,3,324,90.7,1622000,25522480186,294,3278511,2,코미디,"롯데쇼핑㈜롯데엔터테인먼트,(주)리틀빅픽쳐스",남자,여자,여자,2
1417,아이 캔 스피크,2017-09-21,2017-12-15,85,7,5,504,47.0,993000,25523473186,237,3278748,2,코미디,"롯데쇼핑㈜롯데엔터테인먼트,(주)리틀빅픽쳐스",남자,여자,여자,2
1418,아이 캔 스피크,2017-09-21,2017-12-18,88,1,1,40,15.0,48000,25523521186,6,3278754,2,코미디,"롯데쇼핑㈜롯데엔터테인먼트,(주)리틀빅픽쳐스",남자,여자,여자,2
1419,아이 캔 스피크,2017-09-21,2017-12-20,90,2,2,76,40.8,188000,25523709186,31,3278785,2,코미디,"롯데쇼핑㈜롯데엔터테인먼트,(주)리틀빅픽쳐스",남자,여자,여자,2
1420,아이 캔 스피크,2017-09-21,2017-12-21,91,2,2,225,81.3,1115000,25524824186,183,3278968,2,코미디,"롯데쇼핑㈜롯데엔터테인먼트,(주)리틀빅픽쳐스",남자,여자,여자,2
1421,아이 캔 스피크,2017-09-21,2017-12-22,92,1,1,128,98.4,504000,25525328186,126,3279094,2,코미디,"롯데쇼핑㈜롯데엔터테인먼트,(주)리틀빅픽쳐스",남자,여자,여자,2
1422,아이 캔 스피크,2017-09-21,2017-12-26,96,1,1,97,100.0,388000,25525716186,97,3279191,2,코미디,"롯데쇼핑㈜롯데엔터테인먼트,(주)리틀빅픽쳐스",남자,여자,여자,2
1423,아이 캔 스피크,2017-09-21,2017-12-28,98,1,1,293,35.8,735000,25526451186,105,3279296,2,코미디,"롯데쇼핑㈜롯데엔터테인먼트,(주)리틀빅픽쳐스",남자,여자,여자,2
1424,아이 캔 스피크,2017-09-21,2018-01-19,120,6,6,868,12.7,640000,25527091186,110,3279406,2,코미디,"롯데쇼핑㈜롯데엔터테인먼트,(주)리틀빅픽쳐스",남자,여자,여자,2
1425,아이 캔 스피크,2017-09-21,2018-01-20,121,3,3,417,36.5,878200,25527969386,152,3279558,2,코미디,"롯데쇼핑㈜롯데엔터테인먼트,(주)리틀빅픽쳐스",남자,여자,여자,2
1426,아이 캔 스피크,2017-09-21,2018-01-21,122,5,5,695,19.6,776000,25528745386,136,3279694,2,코미디,"롯데쇼핑㈜롯데엔터테인먼트,(주)리틀빅픽쳐스",남자,여자,여자,2
1427,아이 캔 스피크,2017-09-21,2018-01-26,127,4,4,518,11.2,351000,25529096386,58,3279752,2,코미디,"롯데쇼핑㈜롯데엔터테인먼트,(주)리틀빅픽쳐스",남자,여자,여자,2
1428,아이 캔 스피크,2017-09-21,2018-01-27,128,4,4,583,12.9,431000,25529527386,75,3279827,2,코미디,"롯데쇼핑㈜롯데엔터테인먼트,(주)리틀빅픽쳐스",남자,여자,여자,2
1429,아이 캔 스피크,2017-09-21,2018-01-28,129,1,1,146,13.7,123600,25529650986,20,3279847,2,코미디,"롯데쇼핑㈜롯데엔터테인먼트,(주)리틀빅픽쳐스",남자,여자,여자,2
1430,아이 캔 스피크,2017-09-21,2018-02-01,133,3,3,426,59.2,1260000,25530910986,252,3280099,2,코미디,"롯데쇼핑㈜롯데엔터테인먼트,(주)리틀빅픽쳐스",남자,여자,여자,2
1431,아이 캔 스피크,2017-09-21,2018-02-07,139,1,1,186,77.4,1304000,25532214986,144,3280243,2,코미디,"롯데쇼핑㈜롯데엔터테인먼트,(주)리틀빅픽쳐스",남자,여자,여자,2
1432,아이 캔 스피크,2017-09-21,2018-03-13,173,1,1,55,100.0,275000,25532489986,55,3280298,2,코미디,"롯데쇼핑㈜롯데엔터테인먼트,(주)리틀빅픽쳐스",남자,여자,여자,2
1433,아이 캔 스피크,2017-09-21,2018-04-24,215,3,3,483,68.9,1974000,25534463986,333,3280631,2,코미디,"롯데쇼핑㈜롯데엔터테인먼트,(주)리틀빅픽쳐스",남자,여자,여자,2
1434,아이 캔 스피크,2017-09-21,2018-05-16,237,1,1,144,0.0,0,25534463986,0,3280631,2,코미디,"롯데쇼핑㈜롯데엔터테인먼트,(주)리틀빅픽쳐스",남자,여자,여자,2
1435,아이 캔 스피크,2017-09-21,2018-05-18,239,1,1,103,68.0,420000,25534883986,70,3280701,2,코미디,"롯데쇼핑㈜롯데엔터테인먼트,(주)리틀빅픽쳐스",남자,여자,여자,2
1436,아이 캔 스피크,2017-09-21,2018-05-24,245,1,1,103,68.0,420000,25535303986,70,3280771,2,코미디,"롯데쇼핑㈜롯데엔터테인먼트,(주)리틀빅픽쳐스",남자,여자,여자,2
1437,아이 캔 스피크,2017-09-21,2018-05-25,246,1,1,103,68.0,420000,25535723986,70,3280841,2,코미디,"롯데쇼핑㈜롯데엔터테인먼트,(주)리틀빅픽쳐스",남자,여자,여자,2
1438,아이 캔 스피크,2017-09-21,2018-05-31,252,1,1,126,38.1,240000,25535963986,48,3280889,2,코미디,"롯데쇼핑㈜롯데엔터테인먼트,(주)리틀빅픽쳐스",남자,여자,여자,2
1439,아이 캔 스피크,2017-09-21,2018-06-12,264,1,1,293,35.5,728000,25536691986,104,3280993,2,코미디,"롯데쇼핑㈜롯데엔터테인먼트,(주)리틀빅픽쳐스",남자,여자,여자,2
1440,아이 캔 스피크,2017-09-21,2018-07-03,285,2,2,364,92.9,2578000,25539269986,338,3281331,2,코미디,"롯데쇼핑㈜롯데엔터테인먼트,(주)리틀빅픽쳐스",남자,여자,여자,2
1441,아이 캔 스피크,2017-09-21,2018-07-20,302,1,1,57,79.0,180000,25539449986,45,3281376,2,코미디,"롯데쇼핑㈜롯데엔터테인먼트,(주)리틀빅픽쳐스",남자,여자,여자,2
1442,아이 캔 스피크,2017-09-21,2018-07-25,307,1,1,57,100.0,285000,25539734986,57,3281433,2,코미디,"롯데쇼핑㈜롯데엔터테인먼트,(주)리틀빅픽쳐스",남자,여자,여자,2
1443,아이 캔 스피크,2017-09-21,2018-09-12,356,1,1,293,85.3,1500000,25541234986,250,3281683,2,코미디,"롯데쇼핑㈜롯데엔터테인먼트,(주)리틀빅픽쳐스",남자,여자,여자,2
1444,아이 캔 스피크,2017-09-21,2018-10-01,375,1,1,119,68.1,405000,25541639986,81,3281764,2,코미디,"롯데쇼핑㈜롯데엔터테인먼트,(주)리틀빅픽쳐스",남자,여자,여자,2
1445,아이 캔 스피크,2017-09-21,2018-10-23,397,1,1,114,100.0,570000,25542209986,114,3281878,2,코미디,"롯데쇼핑㈜롯데엔터테인먼트,(주)리틀빅픽쳐스",남자,여자,여자,2
1446,아이 캔 스피크,2017-09-21,2018-10-26,400,1,1,89,80.9,360000,25542569986,72,3281950,2,코미디,"롯데쇼핑㈜롯데엔터테인먼트,(주)리틀빅픽쳐스",남자,여자,여자,2
1447,아이 캔 스피크,2017-09-21,2018-10-27,401,1,1,146,96.6,1551000,25544120986,141,3282091,2,코미디,"롯데쇼핑㈜롯데엔터테인먼트,(주)리틀빅픽쳐스",남자,여자,여자,2
1448,아이 캔 스피크,2017-09-21,2018-11-07,412,1,1,109,0.0,0,25544120986,0,3282091,2,코미디,"롯데쇼핑㈜롯데엔터테인먼트,(주)리틀빅픽쳐스",남자,여자,여자,2
1449,아이 캔 스피크,2017-09-21,2018-11-20,425,1,1,134,74.6,500000,25544620986,100,3282191,2,코미디,"롯데쇼핑㈜롯데엔터테인먼트,(주)리틀빅픽쳐스",남자,여자,여자,2
1450,아이 캔 스피크,2017-09-21,2018-11-21,426,1,1,134,59.7,400000,25545020986,80,3282271,2,코미디,"롯데쇼핑㈜롯데엔터테인먼트,(주)리틀빅픽쳐스",남자,여자,여자,2
1451,아이 캔 스피크,2017-09-21,2019-05-07,593,1,1,149,73.8,550000,25545570986,110,3282381,2,코미디,"롯데쇼핑㈜롯데엔터테인먼트,(주)리틀빅픽쳐스",남자,여자,여자,2
1452,아이 캔 스피크,2017-09-21,2019-06-21,638,1,1,132,31.1,205000,25545775986,41,3282422,2,코미디,"롯데쇼핑㈜롯데엔터테인먼트,(주)리틀빅픽쳐스",남자,여자,여자,2
1453,아이 캔 스피크,2017-09-21,2019-08-02,680,1,1,93,80.7,375000,25546150986,75,3282497,2,코미디,"롯데쇼핑㈜롯데엔터테인먼트,(주)리틀빅픽쳐스",남자,여자,여자,2
1454,아이 캔 스피크,2017-09-21,2019-08-17,695,2,2,90,100.0,540000,25546690986,90,3282587,2,코미디,"롯데쇼핑㈜롯데엔터테인먼트,(주)리틀빅픽쳐스",남자,여자,여자,2
1455,남한산성,2017-10-03,2017-09-18,-15,1,1,247,100.0,1482000,1482000,247,247,0,"사극,드라마",씨제이이앤엠(주),남자,남자,남자,0
1456,남한산성,2017-10-03,2017-09-25,-8,19,12,4004,91.9,30010000,31492000,3680,3927,0,"사극,드라마",씨제이이앤엠(주),남자,남자,남자,0
1457,남한산성,2017-10-03,2017-09-26,-7,23,23,5443,53.1,28977800,60469800,2888,6815,0,"사극,드라마",씨제이이앤엠(주),남자,남자,남자,0
1458,남한산성,2017-10-03,2017-09-27,-6,15,15,2954,97.8,21644000,82113800,2889,9704,0,"사극,드라마",씨제이이앤엠(주),남자,남자,남자,0
1459,남한산성,2017-10-03,2017-09-28,-5,13,12,2821,94.2,21272000,103385800,2658,12362,0,"사극,드라마",씨제이이앤엠(주),남자,남자,남자,0
1460,남한산성,2017-10-03,2017-09-29,-4,23,23,4323,99.7,36902000,140287800,4310,16672,0,"사극,드라마",씨제이이앤엠(주),남자,남자,남자,0
1461,남한산성,2017-10-03,2017-09-30,-3,20,20,2599,97.1,17474000,157761800,2524,19196,0,"사극,드라마",씨제이이앤엠(주),남자,남자,남자,0
1462,남한산성,2017-10-03,2017-10-02,-1,41,40,9764,99.6,77640000,235401800,9722,28918,0,"사극,드라마",씨제이이앤엠(주),남자,남자,남자,0
1463,남한산성,2017-10-03,2017-10-03,0,5284,1125,1006315,44.2,3669119900,3904521700,444585,473503,0,"사극,드라마",씨제이이앤엠(주),남자,남자,남자,0
1464,남한산성,2017-10-03,2017-10-04,1,5390,1165,1030277,53.7,4655991000,8560512700,552722,1026225,0,"사극,드라마",씨제이이앤엠(주),남자,남자,남자,0
1465,남한산성,2017-10-03,2017-10-05,2,5528,1205,1060520,56.6,4940801300,13501314000,599797,1626022,0,"사극,드라마",씨제이이앤엠(주),남자,남자,남자,0
1466,남한산성,2017-10-03,2017-10-06,3,5466,1221,1054964,55.2,4731723954,18233037954,582294,2208316,0,"사극,드라마",씨제이이앤엠(주),남자,남자,남자,0
1467,남한산성,2017-10-03,2017-10-07,4,5439,1229,1047525,40.6,3471456338,21704494292,424767,2633083,0,"사극,드라마",씨제이이앤엠(주),남자,남자,남자,0
1468,남한산성,2017-10-03,2017-10-08,5,5212,1203,1004809,36.4,3004716900,24709211192,365976,2999059,0,"사극,드라마",씨제이이앤엠(주),남자,남자,남자,0
1469,남한산성,2017-10-03,2017-10-09,6,4835,1152,930666,27.6,2050060400,26759271592,256815,3255874,0,"사극,드라마",씨제이이앤엠(주),남자,남자,남자,0
1470,남한산성,2017-10-03,2017-10-10,7,4332,1011,786784,7.2,400933000,27160204592,56673,3312547,0,"사극,드라마",씨제이이앤엠(주),남자,남자,남자,0
1471,남한산성,2017-10-03,2017-10-11,8,4235,1005,760343,7.6,407708900,27567913492,57962,3370509,0,"사극,드라마",씨제이이앤엠(주),남자,남자,남자,0
1472,남한산성,2017-10-03,2017-10-12,9,2370,702,372655,11.2,293178900,27861092392,41895,3412404,0,"사극,드라마",씨제이이앤엠(주),남자,남자,남자,0
1473,남한산성,2017-10-03,2017-10-13,10,2343,692,364114,13.1,369514200,28230606592,47562,3459966,0,"사극,드라마",씨제이이앤엠(주),남자,남자,남자,0
1474,남한산성,2017-10-03,2017-10-14,11,2311,668,360954,22.3,660539400,28891145992,80501,3540467,0,"사극,드라마",씨제이이앤엠(주),남자,남자,남자,0
1475,남한산성,2017-10-03,2017-10-15,12,2259,646,353050,21.9,632397900,29523543892,77188,3617655,0,"사극,드라마",씨제이이앤엠(주),남자,남자,남자,0
1476,남한산성,2017-10-03,2017-10-16,13,2191,643,333231,8.0,189482700,29713026592,26676,3644331,0,"사극,드라마",씨제이이앤엠(주),남자,남자,남자,0
1477,남한산성,2017-10-03,2017-10-17,14,2180,674,326754,8.1,183531000,29896557592,26446,3670777,0,"사극,드라마",씨제이이앤엠(주),남자,남자,남자,0
1478,남한산성,2017-10-03,2017-10-18,15,2137,653,323232,8.1,185601200,30082158792,26315,3697092,0,"사극,드라마",씨제이이앤엠(주),남자,남자,남자,0
1479,남한산성,2017-10-03,2017-10-19,16,1020,436,129815,10.1,90976400,30173135192,13110,3710202,0,"사극,드라마",씨제이이앤엠(주),남자,남자,남자,0
1480,남한산성,2017-10-03,2017-10-20,17,1033,451,131861,11.9,120194000,30293329192,15706,3725908,0,"사극,드라마",씨제이이앤엠(주),남자,남자,남자,0
1481,남한산성,2017-10-03,2017-10-21,18,1076,476,137614,17.8,199143600,30492472792,24432,3750340,0,"사극,드라마",씨제이이앤엠(주),남자,남자,남자,0
1482,남한산성,2017-10-03,2017-10-22,19,1019,450,132902,18.3,200085700,30692558492,24339,3774679,0,"사극,드라마",씨제이이앤엠(주),남자,남자,남자,0
1483,남한산성,2017-10-03,2017-10-23,20,1003,429,129664,7.1,65910200,30758468692,9246,3783925,0,"사극,드라마",씨제이이앤엠(주),남자,남자,남자,0
1484,남한산성,2017-10-03,2017-10-24,21,1018,446,131588,8.0,73959500,30832428192,10521,3794446,0,"사극,드라마",씨제이이앤엠(주),남자,남자,남자,0
1485,남한산성,2017-10-03,2017-10-25,22,311,221,36518,14.2,32010500,30864438692,5196,3799642,0,"사극,드라마",씨제이이앤엠(주),남자,남자,남자,0
1486,남한산성,2017-10-03,2017-10-26,23,339,230,40849,13.1,35902000,30900340692,5335,3804977,0,"사극,드라마",씨제이이앤엠(주),남자,남자,남자,0
1487,남한산성,2017-10-03,2017-10-27,24,328,229,39751,16.7,50160700,30950501392,6635,3811612,0,"사극,드라마",씨제이이앤엠(주),남자,남자,남자,0
1488,남한산성,2017-10-03,2017-10-28,25,257,182,29985,22.5,54646500,31005147892,6754,3818366,0,"사극,드라마",씨제이이앤엠(주),남자,남자,남자,0
1489,남한산성,2017-10-03,2017-10-29,26,262,182,30026,26.2,63582500,31068730392,7857,3826223,0,"사극,드라마",씨제이이앤엠(주),남자,남자,남자,0
1490,남한산성,2017-10-03,2017-10-30,27,356,225,42695,9.1,26964700,31095695092,3883,3830106,0,"사극,드라마",씨제이이앤엠(주),남자,남자,남자,0
1491,남한산성,2017-10-03,2017-10-31,28,354,232,41941,11.4,31493400,31127188492,4765,3834871,0,"사극,드라마",씨제이이앤엠(주),남자,남자,남자,0
1492,남한산성,2017-10-03,2017-11-01,29,342,215,40754,8.1,23035400,31150223892,3296,3838167,0,"사극,드라마",씨제이이앤엠(주),남자,남자,남자,0
1493,남한산성,2017-10-03,2017-11-02,30,51,41,5601,11.7,4403500,31154627392,656,3838823,0,"사극,드라마",씨제이이앤엠(주),남자,남자,남자,0
1494,남한산성,2017-10-03,2017-11-03,31,52,42,5915,13.9,6169500,31160796892,823,3839646,0,"사극,드라마",씨제이이앤엠(주),남자,남자,남자,0
1495,남한산성,2017-10-03,2017-11-04,32,31,25,3155,18.1,4661500,31165458392,571,3840217,0,"사극,드라마",씨제이이앤엠(주),남자,남자,남자,0
1496,남한산성,2017-10-03,2017-11-05,33,27,22,2416,22.6,4607300,31170065692,545,3840762,0,"사극,드라마",씨제이이앤엠(주),남자,남자,남자,0
1497,남한산성,2017-10-03,2017-11-06,34,46,35,5169,6.5,2314500,31172380192,336,3841098,0,"사극,드라마",씨제이이앤엠(주),남자,남자,남자,0
1498,남한산성,2017-10-03,2017-11-07,35,50,38,5577,6.2,2417500,31174797692,344,3841442,0,"사극,드라마",씨제이이앤엠(주),남자,남자,남자,0
1499,남한산성,2017-10-03,2017-11-08,36,48,42,5922,8.3,3224000,31178021692,493,3841935,0,"사극,드라마",씨제이이앤엠(주),남자,남자,남자,0
1500,남한산성,2017-10-03,2017-11-09,37,38,36,5666,15.8,7114000,31185135692,896,3842831,0,"사극,드라마",씨제이이앤엠(주),남자,남자,남자,0
1501,남한산성,2017-10-03,2017-11-10,38,36,35,4952,10.5,3061500,31188197192,518,3843349,0,"사극,드라마",씨제이이앤엠(주),남자,남자,남자,0
1502,남한산성,2017-10-03,2017-11-11,39,26,26,4106,15.8,4317000,31192514192,648,3843997,0,"사극,드라마",씨제이이앤엠(주),남자,남자,남자,0
1503,남한산성,2017-10-03,2017-11-12,40,24,24,3624,10.4,2753200,31195267392,375,3844372,0,"사극,드라마",씨제이이앤엠(주),남자,남자,남자,0
1504,남한산성,2017-10-03,2017-11-13,41,35,32,5020,12.4,4098500,31199365892,621,3844993,0,"사극,드라마",씨제이이앤엠(주),남자,남자,남자,0
1505,남한산성,2017-10-03,2017-11-14,42,37,35,5202,11.6,4270000,31203635892,603,3845596,0,"사극,드라마",씨제이이앤엠(주),남자,남자,남자,0
1506,남한산성,2017-10-03,2017-11-15,43,22,22,3064,10.9,2101000,31205736892,333,3845929,0,"사극,드라마",씨제이이앤엠(주),남자,남자,남자,0
1507,남한산성,2017-10-03,2017-11-16,44,14,14,1944,8.3,885000,31206621892,162,3846091,0,"사극,드라마",씨제이이앤엠(주),남자,남자,남자,0
1508,남한산성,2017-10-03,2017-11-17,45,20,20,3098,7.5,1457000,31208078892,233,3846324,0,"사극,드라마",씨제이이앤엠(주),남자,남자,남자,0
1509,남한산성,2017-10-03,2017-11-18,46,18,18,2903,6.7,1269500,31209348392,195,3846519,0,"사극,드라마",씨제이이앤엠(주),남자,남자,남자,0
1510,남한산성,2017-10-03,2017-11-19,47,18,18,2823,8.9,1730900,31211079292,250,3846769,0,"사극,드라마",씨제이이앤엠(주),남자,남자,남자,0
1511,남한산성,2017-10-03,2017-11-20,48,22,22,3298,5.7,1116500,31212195792,189,3846958,0,"사극,드라마",씨제이이앤엠(주),남자,남자,남자,0
1512,남한산성,2017-10-03,2017-11-21,49,20,20,2836,17.2,3367000,31215562792,487,3847445,0,"사극,드라마",씨제이이앤엠(주),남자,남자,남자,0
1513,남한산성,2017-10-03,2017-11-22,50,16,15,1942,3.3,417000,31215979792,64,3847509,0,"사극,드라마",씨제이이앤엠(주),남자,남자,남자,0
1514,남한산성,2017-10-03,2017-11-23,51,8,8,872,3.9,226000,31216205792,34,3847543,0,"사극,드라마",씨제이이앤엠(주),남자,남자,남자,0
1515,남한산성,2017-10-03,2017-11-24,52,10,9,1185,30.0,3164500,31219370292,356,3847899,0,"사극,드라마",씨제이이앤엠(주),남자,남자,남자,0
1516,남한산성,2017-10-03,2017-11-25,53,7,7,1012,3.5,298500,31219668792,35,3847934,0,"사극,드라마",씨제이이앤엠(주),남자,남자,남자,0
1517,남한산성,2017-10-03,2017-11-26,54,7,7,1042,2.3,181000,31219849792,24,3847958,0,"사극,드라마",씨제이이앤엠(주),남자,남자,남자,0
1518,남한산성,2017-10-03,2017-11-27,55,8,8,1138,1.8,124000,31219973792,20,3847978,0,"사극,드라마",씨제이이앤엠(주),남자,남자,남자,0
1519,남한산성,2017-10-03,2017-11-28,56,11,11,1591,2.1,227000,31220200792,33,3848011,0,"사극,드라마",씨제이이앤엠(주),남자,남자,남자,0
1520,남한산성,2017-10-03,2017-11-29,57,1,1,100,2.0,13000,31220213792,2,3848013,0,"사극,드라마",씨제이이앤엠(주),남자,남자,남자,0
1521,남한산성,2017-10-03,2017-12-01,59,1,1,165,57.6,570000,31220783792,95,3848108,0,"사극,드라마",씨제이이앤엠(주),남자,남자,남자,0
1522,남한산성,2017-10-03,2017-12-04,62,1,1,62,96.8,240000,31221023792,60,3848168,0,"사극,드라마",씨제이이앤엠(주),남자,남자,남자,0
1523,남한산성,2017-10-03,2017-12-05,63,1,1,35,85.7,120000,31221143792,30,3848198,0,"사극,드라마",씨제이이앤엠(주),남자,남자,남자,0
1524,남한산성,2017-10-03,2017-12-07,65,1,1,164,56.1,368000,31221511792,92,3848290,0,"사극,드라마",씨제이이앤엠(주),남자,남자,남자,0
1525,남한산성,2017-10-03,2017-12-08,66,2,1,328,47.6,624000,31222135792,156,3848446,0,"사극,드라마",씨제이이앤엠(주),남자,남자,남자,0
1526,남한산성,2017-10-03,2017-12-12,70,1,1,32,100.0,256000,31222391792,32,3848478,0,"사극,드라마",씨제이이앤엠(주),남자,남자,남자,0
1527,남한산성,2017-10-03,2017-12-14,72,2,2,345,87.0,1200000,31223591792,300,3848778,0,"사극,드라마",씨제이이앤엠(주),남자,남자,남자,0
1528,남한산성,2017-10-03,2017-12-19,77,2,2,64,100.0,512000,31224103792,64,3848842,0,"사극,드라마",씨제이이앤엠(주),남자,남자,남자,0
1529,남한산성,2017-10-03,2017-12-26,84,1,1,181,91.2,660000,31224763792,165,3849007,0,"사극,드라마",씨제이이앤엠(주),남자,남자,남자,0
1530,남한산성,2017-10-03,2017-12-27,85,1,1,181,44.2,320000,31225083792,80,3849087,0,"사극,드라마",씨제이이앤엠(주),남자,남자,남자,0
1531,남한산성,2017-10-03,2018-04-22,201,1,1,82,51.2,336000,31225419792,42,3849129,0,"사극,드라마",씨제이이앤엠(주),남자,남자,남자,0
1532,강철비,2017-12-14,2017-11-15,-29,6,3,1454,96.6,11664000,11664000,1404,1404,0,"액션,드라마",(주)넥스트엔터테인먼트월드(NEW),남자,남자,남자,0
1533,강철비,2017-12-14,2017-12-10,-4,1,1,247,100.0,1729000,13393000,247,1651,0,"액션,드라마",(주)넥스트엔터테인먼트월드(NEW),남자,남자,남자,0
1534,강철비,2017-12-14,2017-12-11,-3,18,17,4924,95.6,37640000,51033000,4705,6356,0,"액션,드라마",(주)넥스트엔터테인먼트월드(NEW),남자,남자,남자,0
1535,강철비,2017-12-14,2017-12-12,-2,42,41,9244,65.0,53672700,104705700,6004,12360,0,"액션,드라마",(주)넥스트엔터테인먼트월드(NEW),남자,남자,남자,0
1536,강철비,2017-12-14,2017-12-13,-1,32,28,5381,69.7,28363000,133068700,3752,16112,0,"액션,드라마",(주)넥스트엔터테인먼트월드(NEW),남자,남자,남자,0
1537,강철비,2017-12-14,2017-12-14,0,5247,1259,944982,25.1,1711379500,1844448200,236952,253064,0,"액션,드라마",(주)넥스트엔터테인먼트월드(NEW),남자,남자,남자,0
1538,강철비,2017-12-14,2017-12-15,1,5455,1276,980362,29.5,2318547610,4162995810,288951,542015,0,"액션,드라마",(주)넥스트엔터테인먼트월드(NEW),남자,남자,남자,0
1539,강철비,2017-12-14,2017-12-16,2,6102,1419,1104218,48.8,4481554006,8644549816,539301,1081316,0,"액션,드라마",(주)넥스트엔터테인먼트월드(NEW),남자,남자,남자,0
1540,강철비,2017-12-14,2017-12-17,3,6152,1426,1109113,50.8,4689844200,13334394016,563824,1645140,0,"액션,드라마",(주)넥스트엔터테인먼트월드(NEW),남자,남자,남자,0
1541,강철비,2017-12-14,2017-12-18,4,5841,1332,1068482,22.1,1744647900,15079041916,235668,1880808,0,"액션,드라마",(주)넥스트엔터테인먼트월드(NEW),남자,남자,남자,0
1542,강철비,2017-12-14,2017-12-19,5,5934,1390,1080332,21.3,1695385850,16774427766,230227,2111035,0,"액션,드라마",(주)넥스트엔터테인먼트월드(NEW),남자,남자,남자,0
1543,강철비,2017-12-14,2017-12-20,6,3643,988,567634,25.0,1055543000,17829970766,142017,2253052,0,"액션,드라마",(주)넥스트엔터테인먼트월드(NEW),남자,남자,남자,0
1544,강철비,2017-12-14,2017-12-21,7,3477,944,540209,22.6,902201700,18732172466,122170,2375222,0,"액션,드라마",(주)넥스트엔터테인먼트월드(NEW),남자,남자,남자,0
1545,강철비,2017-12-14,2017-12-22,8,3689,1005,566126,25.8,1195700446,19927872912,146049,2521271,0,"액션,드라마",(주)넥스트엔터테인먼트월드(NEW),남자,남자,남자,0
1546,강철비,2017-12-14,2017-12-23,9,3564,970,546647,50.0,2279807110,22207680022,273400,2794671,0,"액션,드라마",(주)넥스트엔터테인먼트월드(NEW),남자,남자,남자,0
1547,강철비,2017-12-14,2017-12-24,10,3399,925,519770,69.7,3032771600,25240451622,362188,3156859,0,"액션,드라마",(주)넥스트엔터테인먼트월드(NEW),남자,남자,남자,0
1548,강철비,2017-12-14,2017-12-25,11,3197,901,485133,67.9,2715803400,27956255022,329396,3486255,0,"액션,드라마",(주)넥스트엔터테인먼트월드(NEW),남자,남자,남자,0
1549,강철비,2017-12-14,2017-12-26,12,3388,909,504345,20.5,767703000,28723958022,103605,3589860,0,"액션,드라마",(주)넥스트엔터테인먼트월드(NEW),남자,남자,남자,0
1550,강철비,2017-12-14,2017-12-27,13,1599,610,202311,37.6,457801400,29181759422,76078,3665938,0,"액션,드라마",(주)넥스트엔터테인먼트월드(NEW),남자,남자,남자,0
1551,강철비,2017-12-14,2017-12-28,14,1512,579,191267,29.8,420062500,29601821922,56930,3722868,0,"액션,드라마",(주)넥스트엔터테인먼트월드(NEW),남자,남자,남자,0
1552,강철비,2017-12-14,2017-12-29,15,1532,599,191010,37.0,579655990,30181477912,70645,3793513,0,"액션,드라마",(주)넥스트엔터테인먼트월드(NEW),남자,남자,남자,0
1553,강철비,2017-12-14,2017-12-30,16,1446,569,175602,56.9,820374754,31001852666,99934,3893447,0,"액션,드라마",(주)넥스트엔터테인먼트월드(NEW),남자,남자,남자,0
1554,강철비,2017-12-14,2017-12-31,17,1484,585,180568,66.9,993044900,31994897566,120846,4014293,0,"액션,드라마",(주)넥스트엔터테인먼트월드(NEW),남자,남자,남자,0
1555,강철비,2017-12-14,2018-01-01,18,1451,602,178286,64.1,944228600,32939126166,114298,4128591,0,"액션,드라마",(주)넥스트엔터테인먼트월드(NEW),남자,남자,남자,0
1556,강철비,2017-12-14,2018-01-02,19,1541,580,191207,25.2,358149600,33297275766,48122,4176713,0,"액션,드라마",(주)넥스트엔터테인먼트월드(NEW),남자,남자,남자,0
1557,강철비,2017-12-14,2018-01-03,20,1225,518,153401,18.6,216057300,33513333066,28596,4205309,0,"액션,드라마",(주)넥스트엔터테인먼트월드(NEW),남자,남자,남자,0
1558,강철비,2017-12-14,2018-01-04,21,1126,502,143020,17.9,193710700,33707043766,25610,4230919,0,"액션,드라마",(주)넥스트엔터테인먼트월드(NEW),남자,남자,남자,0
1559,강철비,2017-12-14,2018-01-05,22,1081,495,133028,20.5,228568100,33935611866,27292,4258211,0,"액션,드라마",(주)넥스트엔터테인먼트월드(NEW),남자,남자,남자,0
1560,강철비,2017-12-14,2018-01-06,23,943,457,114632,43.0,410684600,34346296466,49258,4307469,0,"액션,드라마",(주)넥스트엔터테인먼트월드(NEW),남자,남자,남자,0
1561,강철비,2017-12-14,2018-01-07,24,914,449,111128,38.9,359118000,34705414466,43259,4350728,0,"액션,드라마",(주)넥스트엔터테인먼트월드(NEW),남자,남자,남자,0
1562,강철비,2017-12-14,2018-01-08,25,1001,454,124729,14.1,132094200,34837508666,17562,4368290,0,"액션,드라마",(주)넥스트엔터테인먼트월드(NEW),남자,남자,남자,0
1563,강철비,2017-12-14,2018-01-09,26,972,450,121033,13.5,122211800,34959720466,16294,4384584,0,"액션,드라마",(주)넥스트엔터테인먼트월드(NEW),남자,남자,남자,0
1564,강철비,2017-12-14,2018-01-10,27,938,451,117074,13.2,114744300,35074464766,15391,4399975,0,"액션,드라마",(주)넥스트엔터테인먼트월드(NEW),남자,남자,남자,0
1565,강철비,2017-12-14,2018-01-11,28,292,186,35661,15.1,40684000,35115148766,5400,4405375,0,"액션,드라마",(주)넥스트엔터테인먼트월드(NEW),남자,남자,남자,0
1566,강철비,2017-12-14,2018-01-12,29,299,198,35761,19.9,58631900,35173780666,7118,4412493,0,"액션,드라마",(주)넥스트엔터테인먼트월드(NEW),남자,남자,남자,0
1567,강철비,2017-12-14,2018-01-13,30,267,174,32159,40.3,107703300,35281483966,12962,4425455,0,"액션,드라마",(주)넥스트엔터테인먼트월드(NEW),남자,남자,남자,0
1568,강철비,2017-12-14,2018-01-14,31,259,170,29446,36.6,89073700,35370557666,10776,4436231,0,"액션,드라마",(주)넥스트엔터테인먼트월드(NEW),남자,남자,남자,0
1569,강철비,2017-12-14,2018-01-15,32,290,181,34060,14.1,36320100,35406877766,4808,4441039,0,"액션,드라마",(주)넥스트엔터테인먼트월드(NEW),남자,남자,남자,0
1570,강철비,2017-12-14,2018-01-16,33,289,180,34116,12.7,32225100,35439102866,4348,4445387,0,"액션,드라마",(주)넥스트엔터테인먼트월드(NEW),남자,남자,남자,0
1571,강철비,2017-12-14,2018-01-17,34,55,39,6016,11.7,4974200,35444077066,706,4446093,0,"액션,드라마",(주)넥스트엔터테인먼트월드(NEW),남자,남자,남자,0
1572,강철비,2017-12-14,2018-01-18,35,46,32,4652,13.4,4212100,35448289166,625,4446718,0,"액션,드라마",(주)넥스트엔터테인먼트월드(NEW),남자,남자,남자,0
1573,강철비,2017-12-14,2018-01-19,36,42,33,4248,13.1,4365300,35452654466,558,4447276,0,"액션,드라마",(주)넥스트엔터테인먼트월드(NEW),남자,남자,남자,0
1574,강철비,2017-12-14,2018-01-20,37,41,34,4367,31.0,10384700,35463039166,1353,4448629,0,"액션,드라마",(주)넥스트엔터테인먼트월드(NEW),남자,남자,남자,0
1575,강철비,2017-12-14,2018-01-21,38,43,37,4541,27.0,8728300,35471767466,1225,4449854,0,"액션,드라마",(주)넥스트엔터테인먼트월드(NEW),남자,남자,남자,0
1576,강철비,2017-12-14,2018-01-22,39,40,29,4280,11.3,3372500,35475139966,485,4450339,0,"액션,드라마",(주)넥스트엔터테인먼트월드(NEW),남자,남자,남자,0
1577,강철비,2017-12-14,2018-01-23,40,35,28,3812,9.7,2542000,35477681966,371,4450710,0,"액션,드라마",(주)넥스트엔터테인먼트월드(NEW),남자,남자,남자,0
1578,강철비,2017-12-14,2018-01-24,41,5,4,702,4.8,254000,35477935966,34,4450744,0,"액션,드라마",(주)넥스트엔터테인먼트월드(NEW),남자,남자,남자,0
1579,강철비,2017-12-14,2018-01-25,42,1,1,84,16.7,115000,35478050966,14,4450758,0,"액션,드라마",(주)넥스트엔터테인먼트월드(NEW),남자,남자,남자,0
1580,강철비,2017-12-14,2018-01-26,43,1,1,84,15.5,120000,35478170966,13,4450771,0,"액션,드라마",(주)넥스트엔터테인먼트월드(NEW),남자,남자,남자,0
1581,강철비,2017-12-14,2018-01-27,44,3,3,235,12.3,236000,35478406966,29,4450800,0,"액션,드라마",(주)넥스트엔터테인먼트월드(NEW),남자,남자,남자,0
1582,강철비,2017-12-14,2018-01-28,45,3,2,243,27.2,601000,35479007966,66,4450866,0,"액션,드라마",(주)넥스트엔터테인먼트월드(NEW),남자,남자,남자,0
1583,강철비,2017-12-14,2018-01-29,46,2,1,162,14.2,171000,35479178966,23,4450889,0,"액션,드라마",(주)넥스트엔터테인먼트월드(NEW),남자,남자,남자,0
1584,강철비,2017-12-14,2018-01-30,47,3,2,320,29.4,529000,35479707966,94,4450983,0,"액션,드라마",(주)넥스트엔터테인먼트월드(NEW),남자,남자,남자,0
1585,강철비,2017-12-14,2018-01-31,48,1,1,84,13.1,95000,35479802966,11,4450994,0,"액션,드라마",(주)넥스트엔터테인먼트월드(NEW),남자,남자,남자,0
1586,강철비,2017-12-14,2018-02-01,49,2,2,219,1.4,25000,35479827966,3,4450997,0,"액션,드라마",(주)넥스트엔터테인먼트월드(NEW),남자,남자,남자,0
1587,강철비,2017-12-14,2018-02-02,50,1,1,160,3.1,45000,35479872966,5,4451002,0,"액션,드라마",(주)넥스트엔터테인먼트월드(NEW),남자,남자,남자,0
1588,강철비,2017-12-14,2018-02-03,51,2,2,360,15.3,504000,35480376966,55,4451057,0,"액션,드라마",(주)넥스트엔터테인먼트월드(NEW),남자,남자,남자,0
1589,강철비,2017-12-14,2018-02-04,52,2,2,372,9.1,289000,35480665966,34,4451091,0,"액션,드라마",(주)넥스트엔터테인먼트월드(NEW),남자,남자,남자,0
1590,강철비,2017-12-14,2018-02-05,53,1,1,298,3.7,70000,35480735966,11,4451102,0,"액션,드라마",(주)넥스트엔터테인먼트월드(NEW),남자,남자,남자,0
1591,강철비,2017-12-14,2018-02-06,54,2,2,357,3.4,78000,35480813966,12,4451114,0,"액션,드라마",(주)넥스트엔터테인먼트월드(NEW),남자,남자,남자,0
1592,강철비,2017-12-14,2018-02-07,55,1,1,84,4.8,34000,35480847966,4,4451118,0,"액션,드라마",(주)넥스트엔터테인먼트월드(NEW),남자,남자,남자,0
1593,강철비,2017-12-14,2018-02-09,57,1,1,226,2.7,51000,35480898966,6,4451124,0,"액션,드라마",(주)넥스트엔터테인먼트월드(NEW),남자,남자,남자,0
1594,강철비,2017-12-14,2018-02-10,58,1,1,313,3.2,82000,35480980966,10,4451134,0,"액션,드라마",(주)넥스트엔터테인먼트월드(NEW),남자,남자,남자,0
1595,강철비,2017-12-14,2018-02-11,59,1,1,226,1.3,25000,35481005966,3,4451137,0,"액션,드라마",(주)넥스트엔터테인먼트월드(NEW),남자,남자,남자,0
1596,강철비,2017-12-14,2018-02-12,60,1,1,318,0.6,18000,35481023966,2,4451139,0,"액션,드라마",(주)넥스트엔터테인먼트월드(NEW),남자,남자,남자,0
1597,강철비,2017-12-14,2018-02-13,61,1,1,318,0.9,27000,35481050966,3,4451142,0,"액션,드라마",(주)넥스트엔터테인먼트월드(NEW),남자,남자,남자,0
1598,강철비,2017-12-14,2018-02-19,67,58,40,7815,3.8,1559000,35482609966,296,4451438,0,"액션,드라마",(주)넥스트엔터테인먼트월드(NEW),남자,남자,남자,0
1599,강철비,2017-12-14,2018-02-20,68,51,40,6839,3.0,1109500,35483719466,205,4451643,0,"액션,드라마",(주)넥스트엔터테인먼트월드(NEW),남자,남자,남자,0
1600,강철비,2017-12-14,2018-02-21,69,48,37,6429,2.5,855000,35484574466,159,4451802,0,"액션,드라마",(주)넥스트엔터테인먼트월드(NEW),남자,남자,남자,0
1601,강철비,2017-12-14,2018-02-22,70,40,34,5092,4.4,1148000,35485722466,224,4452026,0,"액션,드라마",(주)넥스트엔터테인먼트월드(NEW),남자,남자,남자,0
1602,강철비,2017-12-14,2018-02-23,71,44,31,5490,3.8,1125000,35486847466,206,4452232,0,"액션,드라마",(주)넥스트엔터테인먼트월드(NEW),남자,남자,남자,0
1603,강철비,2017-12-14,2018-02-24,72,29,26,3617,4.4,868000,35487715466,159,4452391,0,"액션,드라마",(주)넥스트엔터테인먼트월드(NEW),남자,남자,남자,0
1604,강철비,2017-12-14,2018-02-25,73,27,26,3337,3.3,591000,35488306466,109,4452500,0,"액션,드라마",(주)넥스트엔터테인먼트월드(NEW),남자,남자,남자,0
1605,강철비,2017-12-14,2018-02-26,74,37,31,4743,2.3,594000,35488900466,109,4452609,0,"액션,드라마",(주)넥스트엔터테인먼트월드(NEW),남자,남자,남자,0
1606,강철비,2017-12-14,2018-02-27,75,31,27,3810,3.0,595000,35489495466,115,4452724,0,"액션,드라마",(주)넥스트엔터테인먼트월드(NEW),남자,남자,남자,0
1607,강철비,2017-12-14,2018-02-28,76,5,5,599,2.7,81000,35489576466,16,4452740,0,"액션,드라마",(주)넥스트엔터테인먼트월드(NEW),남자,남자,남자,0
1608,강철비,2017-12-14,2018-03-23,99,1,1,117,0.0,0,35489576466,0,4452740,0,"액션,드라마",(주)넥스트엔터테인먼트월드(NEW),남자,남자,남자,0
1609,강철비,2017-12-14,2018-03-28,104,1,1,184,0.0,0,35489576466,0,4452740,0,"액션,드라마",(주)넥스트엔터테인먼트월드(NEW),남자,남자,남자,0
1610,강철비,2017-12-14,2018-07-05,203,1,1,257,0.0,0,35489576466,0,4452740,0,"액션,드라마",(주)넥스트엔터테인먼트월드(NEW),남자,남자,남자,0
1611,강철비,2017-12-14,2019-05-09,511,1,1,110,100.0,770000,35490346466,110,4452850,0,"액션,드라마",(주)넥스트엔터테인먼트월드(NEW),남자,남자,남자,0
1612,그것만이 내 세상,2018-01-17,2017-12-28,-20,1,1,414,100.0,3312000,3312000,414,414,0,"코미디,드라마",씨제이이앤엠(주),남자,남자,남자,0
1613,그것만이 내 세상,2018-01-17,2018-01-03,-14,7,6,1803,87.9,14246000,17558000,1584,1998,0,"코미디,드라마",씨제이이앤엠(주),남자,남자,남자,0
1614,그것만이 내 세상,2018-01-17,2018-01-07,-10,1,1,375,69.6,2610000,20168000,261,2259,0,"코미디,드라마",씨제이이앤엠(주),남자,남자,남자,0
1615,그것만이 내 세상,2018-01-17,2018-01-10,-7,35,34,6479,97.4,51407000,71575000,6307,8566,0,"코미디,드라마",씨제이이앤엠(주),남자,남자,남자,0
1616,그것만이 내 세상,2018-01-17,2018-01-11,-6,9,9,1685,98.0,13311000,84886000,1652,10218,0,"코미디,드라마",씨제이이앤엠(주),남자,남자,남자,0
1617,그것만이 내 세상,2018-01-17,2018-01-12,-5,8,8,1789,100.0,16315000,101201000,1789,12007,0,"코미디,드라마",씨제이이앤엠(주),남자,남자,남자,0
1618,그것만이 내 세상,2018-01-17,2018-01-15,-2,12,12,2373,99.3,21013000,122214000,2357,14364,0,"코미디,드라마",씨제이이앤엠(주),남자,남자,남자,0
1619,그것만이 내 세상,2018-01-17,2018-01-16,-1,55,55,10442,79.9,78678700,200892700,8343,22707,0,"코미디,드라마",씨제이이앤엠(주),남자,남자,남자,0
1620,그것만이 내 세상,2018-01-17,2018-01-17,0,3491,825,602104,21.1,964523300,1165416000,126797,149504,0,"코미디,드라마",씨제이이앤엠(주),남자,남자,남자,0
1621,그것만이 내 세상,2018-01-17,2018-01-18,1,3455,833,591116,19.1,856045100,2021461100,112992,262496,0,"코미디,드라마",씨제이이앤엠(주),남자,남자,남자,0
1622,그것만이 내 세상,2018-01-17,2018-01-19,2,3471,825,585535,22.1,1089467942,3110929042,129275,391771,0,"코미디,드라마",씨제이이앤엠(주),남자,남자,남자,0
1623,그것만이 내 세상,2018-01-17,2018-01-20,3,3490,856,579399,44.8,2185637448,5296566490,259762,651533,0,"코미디,드라마",씨제이이앤엠(주),남자,남자,남자,0
1624,그것만이 내 세상,2018-01-17,2018-01-21,4,3423,861,565678,45.8,2183094200,7479660690,258836,910369,0,"코미디,드라마",씨제이이앤엠(주),남자,남자,남자,0
1625,그것만이 내 세상,2018-01-17,2018-01-22,5,3455,843,571833,17.6,770551400,8250212090,100645,1011014,0,"코미디,드라마",씨제이이앤엠(주),남자,남자,남자,0
1626,그것만이 내 세상,2018-01-17,2018-01-23,6,3485,862,577563,17.9,787874300,9038086390,103234,1114248,0,"코미디,드라마",씨제이이앤엠(주),남자,남자,남자,0
1627,그것만이 내 세상,2018-01-17,2018-01-24,7,3020,754,544818,17.0,711562900,9749649290,92672,1206920,0,"코미디,드라마",씨제이이앤엠(주),남자,남자,남자,0
1628,그것만이 내 세상,2018-01-17,2018-01-25,8,3115,791,571106,17.2,756427000,10506076290,98162,1305082,0,"코미디,드라마",씨제이이앤엠(주),남자,남자,남자,0
1629,그것만이 내 세상,2018-01-17,2018-01-26,9,3349,839,620154,18.9,992149124,11498225414,117046,1422128,0,"코미디,드라마",씨제이이앤엠(주),남자,남자,남자,0
1630,그것만이 내 세상,2018-01-17,2018-01-27,10,3844,951,732748,38.2,2368280238,13866505652,279702,1701830,0,"코미디,드라마",씨제이이앤엠(주),남자,남자,남자,0
1631,그것만이 내 세상,2018-01-17,2018-01-28,11,3803,956,723176,38.2,2334250100,16200755752,275942,1977772,0,"코미디,드라마",씨제이이앤엠(주),남자,남자,남자,0
1632,그것만이 내 세상,2018-01-17,2018-01-29,12,3574,866,685691,13.7,718201600,16918957352,94151,2071923,0,"코미디,드라마",씨제이이앤엠(주),남자,남자,남자,0
1633,그것만이 내 세상,2018-01-17,2018-01-30,13,3574,884,689641,13.3,688320800,17607278152,91515,2163438,0,"코미디,드라마",씨제이이앤엠(주),남자,남자,남자,0
1634,그것만이 내 세상,2018-01-17,2018-01-31,14,2774,706,459342,26.8,721935500,18329213652,123036,2286474,0,"코미디,드라마",씨제이이앤엠(주),남자,남자,남자,0
1635,그것만이 내 세상,2018-01-17,2018-02-01,15,2666,668,441933,14.6,486682800,18815896452,64564,2351038,0,"코미디,드라마",씨제이이앤엠(주),남자,남자,남자,0
1636,그것만이 내 세상,2018-01-17,2018-02-02,16,2872,746,475413,16.5,653956837,19469853289,78474,2429512,0,"코미디,드라마",씨제이이앤엠(주),남자,남자,남자,0
1637,그것만이 내 세상,2018-01-17,2018-02-03,17,3358,855,561746,33.2,1565442648,21035295937,186723,2616235,0,"코미디,드라마",씨제이이앤엠(주),남자,남자,남자,0
1638,그것만이 내 세상,2018-01-17,2018-02-04,18,3371,863,569737,30.9,1477505600,22512801537,175811,2792046,0,"코미디,드라마",씨제이이앤엠(주),남자,남자,남자,0
1639,그것만이 내 세상,2018-01-17,2018-02-05,19,3161,793,552622,9.7,407485000,22920286537,53836,2845882,0,"코미디,드라마",씨제이이앤엠(주),남자,남자,남자,0
1640,그것만이 내 세상,2018-01-17,2018-02-06,20,3264,840,576644,9.7,414881500,23335168037,55685,2901567,0,"코미디,드라마",씨제이이앤엠(주),남자,남자,남자,0
1641,그것만이 내 세상,2018-01-17,2018-02-07,21,3383,860,615622,9.0,411245100,23746413137,55124,2956691,0,"코미디,드라마",씨제이이앤엠(주),남자,남자,남자,0
1642,그것만이 내 세상,2018-01-17,2018-02-08,22,2555,703,413133,10.0,308552700,24054965837,41431,2998122,0,"코미디,드라마",씨제이이앤엠(주),남자,남자,남자,0
1643,그것만이 내 세상,2018-01-17,2018-02-09,23,2602,689,421371,10.7,377659976,24432625813,45104,3043226,0,"코미디,드라마",씨제이이앤엠(주),남자,남자,남자,0
1644,그것만이 내 세상,2018-01-17,2018-02-10,24,2767,724,444500,20.9,780789669,25213415482,92722,3135948,0,"코미디,드라마",씨제이이앤엠(주),남자,남자,남자,0
1645,그것만이 내 세상,2018-01-17,2018-02-11,25,2670,705,431352,19.6,717972900,25931388382,84720,3220668,0,"코미디,드라마",씨제이이앤엠(주),남자,남자,남자,0
1646,그것만이 내 세상,2018-01-17,2018-02-12,26,2510,674,400441,7.1,214763400,26146151782,28443,3249111,0,"코미디,드라마",씨제이이앤엠(주),남자,남자,남자,0
1647,그것만이 내 세상,2018-01-17,2018-02-13,27,2544,692,403871,7.1,215642600,26361794382,28725,3277836,0,"코미디,드라마",씨제이이앤엠(주),남자,남자,남자,0
1648,그것만이 내 세상,2018-01-17,2018-02-14,28,531,318,61437,15.4,70674000,26432468382,9428,3287264,0,"코미디,드라마",씨제이이앤엠(주),남자,남자,남자,0
1649,그것만이 내 세상,2018-01-17,2018-02-15,29,485,312,55294,31.5,145924800,26578393182,17402,3304666,0,"코미디,드라마",씨제이이앤엠(주),남자,남자,남자,0
1650,그것만이 내 세상,2018-01-17,2018-02-16,30,429,288,50461,43.2,183524400,26761917582,21790,3326456,0,"코미디,드라마",씨제이이앤엠(주),남자,남자,남자,0
1651,그것만이 내 세상,2018-01-17,2018-02-17,31,469,305,53428,46.6,204150500,26966068082,24904,3351360,0,"코미디,드라마",씨제이이앤엠(주),남자,남자,남자,0
1652,그것만이 내 세상,2018-01-17,2018-02-18,32,513,315,59609,28.4,138608700,27104676782,16902,3368262,0,"코미디,드라마",씨제이이앤엠(주),남자,남자,남자,0
1653,그것만이 내 세상,2018-01-17,2018-02-19,33,591,345,71652,10.9,54190600,27158867382,7771,3376033,0,"코미디,드라마",씨제이이앤엠(주),남자,남자,남자,0
1654,그것만이 내 세상,2018-01-17,2018-02-20,34,565,340,68327,9.7,45505700,27204373082,6623,3382656,0,"코미디,드라마",씨제이이앤엠(주),남자,남자,남자,0
1655,그것만이 내 세상,2018-01-17,2018-02-21,35,521,321,63427,8.8,37822800,27242195882,5558,3388214,0,"코미디,드라마",씨제이이앤엠(주),남자,남자,남자,0
1656,그것만이 내 세상,2018-01-17,2018-02-22,36,366,236,42404,8.3,22978200,27265174082,3508,3391722,0,"코미디,드라마",씨제이이앤엠(주),남자,남자,남자,0
1657,그것만이 내 세상,2018-01-17,2018-02-23,37,366,232,43081,8.5,25966700,27291140782,3652,3395374,0,"코미디,드라마",씨제이이앤엠(주),남자,남자,남자,0
1658,그것만이 내 세상,2018-01-17,2018-02-24,38,339,211,38863,17.8,48629400,27339770182,6930,3402304,0,"코미디,드라마",씨제이이앤엠(주),남자,남자,남자,0
1659,그것만이 내 세상,2018-01-17,2018-02-25,39,317,199,36929,15.8,41876100,27381646282,5821,3408125,0,"코미디,드라마",씨제이이앤엠(주),남자,남자,남자,0
1660,그것만이 내 세상,2018-01-17,2018-02-26,40,339,211,40282,7.7,20583700,27402229982,3098,3411223,0,"코미디,드라마",씨제이이앤엠(주),남자,남자,남자,0
1661,그것만이 내 세상,2018-01-17,2018-02-27,41,326,206,39058,9.0,23125900,27425355882,3527,3414750,0,"코미디,드라마",씨제이이앤엠(주),남자,남자,남자,0
1662,그것만이 내 세상,2018-01-17,2018-02-28,42,28,26,3744,10.3,2048300,27427404182,385,3415135,0,"코미디,드라마",씨제이이앤엠(주),남자,남자,남자,0
1663,그것만이 내 세상,2018-01-17,2018-03-01,43,6,6,950,49.2,3373600,27430777782,467,3415602,0,"코미디,드라마",씨제이이앤엠(주),남자,남자,남자,0
1664,그것만이 내 세상,2018-01-17,2018-03-02,44,4,4,855,4.0,267800,27431045582,34,3415636,0,"코미디,드라마",씨제이이앤엠(주),남자,남자,남자,0
1665,그것만이 내 세상,2018-01-17,2018-03-03,45,2,2,350,16.3,455800,27431501382,57,3415693,0,"코미디,드라마",씨제이이앤엠(주),남자,남자,남자,0
1666,그것만이 내 세상,2018-01-17,2018-03-04,46,3,3,611,42.6,1663000,27433164382,260,3415953,0,"코미디,드라마",씨제이이앤엠(주),남자,남자,남자,0
1667,그것만이 내 세상,2018-01-17,2018-03-05,47,4,4,505,18.2,497000,27433661382,92,3416045,0,"코미디,드라마",씨제이이앤엠(주),남자,남자,남자,0
1668,그것만이 내 세상,2018-01-17,2018-03-06,48,3,3,354,4.0,104000,27433765382,14,3416059,0,"코미디,드라마",씨제이이앤엠(주),남자,남자,남자,0
1669,그것만이 내 세상,2018-01-17,2018-03-07,49,3,3,500,50.6,1773000,27435538382,253,3416312,0,"코미디,드라마",씨제이이앤엠(주),남자,남자,남자,0
1670,그것만이 내 세상,2018-01-17,2018-03-08,50,2,2,176,2.3,24000,27435562382,4,3416316,0,"코미디,드라마",씨제이이앤엠(주),남자,남자,남자,0
1671,그것만이 내 세상,2018-01-17,2018-03-09,51,3,3,380,9.2,217500,27435779882,35,3416351,0,"코미디,드라마",씨제이이앤엠(주),남자,남자,남자,0
1672,그것만이 내 세상,2018-01-17,2018-03-12,54,2,2,301,7.0,108000,27435887882,21,3416372,0,"코미디,드라마",씨제이이앤엠(주),남자,남자,남자,0
1673,그것만이 내 세상,2018-01-17,2018-03-13,55,2,2,301,10.3,158000,27436045882,31,3416403,0,"코미디,드라마",씨제이이앤엠(주),남자,남자,남자,0
1674,그것만이 내 세상,2018-01-17,2018-03-14,56,3,3,397,64.0,1020000,27437065882,254,3416657,0,"코미디,드라마",씨제이이앤엠(주),남자,남자,남자,0
1675,그것만이 내 세상,2018-01-17,2018-03-15,57,4,4,316,26.0,470500,27437536382,82,3416739,0,"코미디,드라마",씨제이이앤엠(주),남자,남자,남자,0
1676,그것만이 내 세상,2018-01-17,2018-03-19,61,1,1,72,1.4,6000,27437542382,1,3416740,0,"코미디,드라마",씨제이이앤엠(주),남자,남자,남자,0
1677,그것만이 내 세상,2018-01-17,2018-03-20,62,3,3,475,53.9,1497000,27439039382,256,3416996,0,"코미디,드라마",씨제이이앤엠(주),남자,남자,남자,0
1678,그것만이 내 세상,2018-01-17,2018-03-21,63,1,1,138,100.0,966000,27440005382,138,3417134,0,"코미디,드라마",씨제이이앤엠(주),남자,남자,남자,0
1679,그것만이 내 세상,2018-01-17,2018-03-22,64,3,3,262,30.2,330000,27440335382,79,3417213,0,"코미디,드라마",씨제이이앤엠(주),남자,남자,남자,0
1680,그것만이 내 세상,2018-01-17,2018-03-27,69,1,1,72,1.4,5000,27440340382,1,3417214,0,"코미디,드라마",씨제이이앤엠(주),남자,남자,남자,0
1681,그것만이 내 세상,2018-01-17,2018-04-08,81,1,1,110,100.0,590000,27440930382,110,3417324,0,"코미디,드라마",씨제이이앤엠(주),남자,남자,남자,0
1682,그것만이 내 세상,2018-01-17,2018-04-12,85,2,2,460,80.2,1845000,27442775382,369,3417693,0,"코미디,드라마",씨제이이앤엠(주),남자,남자,남자,0
1683,그것만이 내 세상,2018-01-17,2018-04-20,93,1,1,120,100.0,600000,27443375382,120,3417813,0,"코미디,드라마",씨제이이앤엠(주),남자,남자,남자,0
1684,그것만이 내 세상,2018-01-17,2018-04-26,99,1,1,168,100.0,840000,27444215382,168,3417981,0,"코미디,드라마",씨제이이앤엠(주),남자,남자,남자,0
1685,그것만이 내 세상,2018-01-17,2018-05-10,113,1,1,89,69.7,310000,27444525382,62,3418043,0,"코미디,드라마",씨제이이앤엠(주),남자,남자,남자,0
1686,그것만이 내 세상,2018-01-17,2018-06-14,148,1,1,55,78.2,215000,27444740382,43,3418086,0,"코미디,드라마",씨제이이앤엠(주),남자,남자,남자,0
1687,그것만이 내 세상,2018-01-17,2018-06-21,155,1,1,221,57.9,640000,27445380382,128,3418214,0,"코미디,드라마",씨제이이앤엠(주),남자,남자,남자,0
1688,그것만이 내 세상,2018-01-17,2018-06-26,160,1,1,141,100.0,705000,27446085382,141,3418355,0,"코미디,드라마",씨제이이앤엠(주),남자,남자,남자,0
1689,그것만이 내 세상,2018-01-17,2018-07-23,187,1,1,164,0.0,0,27446085382,0,3418355,0,"코미디,드라마",씨제이이앤엠(주),남자,남자,남자,0
1690,그것만이 내 세상,2018-01-17,2018-09-04,230,1,1,278,0.4,5000,27446090382,1,3418356,0,"코미디,드라마",씨제이이앤엠(주),남자,남자,남자,0
1691,그것만이 내 세상,2018-01-17,2018-09-10,236,1,1,123,100.0,615000,27446705382,123,3418479,0,"코미디,드라마",씨제이이앤엠(주),남자,남자,남자,0
1692,그것만이 내 세상,2018-01-17,2018-09-18,244,1,1,183,100.0,1464000,27448169382,183,3418662,0,"코미디,드라마",씨제이이앤엠(주),남자,남자,남자,0
1693,그것만이 내 세상,2018-01-17,2018-09-27,253,1,1,114,100.0,570000,27448739382,114,3418776,0,"코미디,드라마",씨제이이앤엠(주),남자,남자,남자,0
1694,그것만이 내 세상,2018-01-17,2018-10-30,286,1,1,223,65.9,735000,27449474382,147,3418923,0,"코미디,드라마",씨제이이앤엠(주),남자,남자,남자,0
1695,그것만이 내 세상,2018-01-17,2018-10-31,287,1,1,223,38.1,425000,27449899382,85,3419008,0,"코미디,드라마",씨제이이앤엠(주),남자,남자,남자,0
1696,그것만이 내 세상,2018-01-17,2018-11-16,303,1,1,193,53.4,515000,27450414382,103,3419111,0,"코미디,드라마",씨제이이앤엠(주),남자,남자,남자,0
1697,그것만이 내 세상,2018-01-17,2018-11-21,308,1,1,193,65.8,635000,27451049382,127,3419238,0,"코미디,드라마",씨제이이앤엠(주),남자,남자,남자,0
1698,그것만이 내 세상,2018-01-17,2018-12-04,321,1,1,160,100.0,1016000,27452065382,160,3419398,0,"코미디,드라마",씨제이이앤엠(주),남자,남자,남자,0
1699,그것만이 내 세상,2018-01-17,2018-12-06,323,2,1,242,57.0,830000,27452895382,138,3419536,0,"코미디,드라마",씨제이이앤엠(주),남자,남자,남자,0
1700,그것만이 내 세상,2018-01-17,2018-12-12,329,1,1,137,100.0,822000,27453717382,137,3419673,0,"코미디,드라마",씨제이이앤엠(주),남자,남자,남자,0
1701,그것만이 내 세상,2018-01-17,2018-12-28,345,1,1,87,92.0,400000,27454117382,80,3419753,0,"코미디,드라마",씨제이이앤엠(주),남자,남자,남자,0
1702,그것만이 내 세상,2018-01-17,2019-10-10,631,1,1,195,100.0,1560000,27455677382,195,3419948,0,"코미디,드라마",씨제이이앤엠(주),남자,남자,남자,0
1703,조선명탐정: 흡혈괴마의 비밀,2018-02-08,2018-01-29,-10,20,20,4930,99.5,38781000,38781000,4906,4906,1,"사극,어드벤처,코미디",(주)쇼박스,남자,여자,남자,1
1704,조선명탐정: 흡혈괴마의 비밀,2018-02-08,2018-01-30,-9,72,72,11745,99.4,74910000,113691000,11673,16579,1,"사극,어드벤처,코미디",(주)쇼박스,남자,여자,남자,1
1705,조선명탐정: 흡혈괴마의 비밀,2018-02-08,2018-01-31,-8,12,12,3569,90.1,18215000,131906000,3214,19793,1,"사극,어드벤처,코미디",(주)쇼박스,남자,여자,남자,1
1706,조선명탐정: 흡혈괴마의 비밀,2018-02-08,2018-02-01,-7,34,34,5938,97.5,47239000,179145000,5787,25580,1,"사극,어드벤처,코미디",(주)쇼박스,남자,여자,남자,1
1707,조선명탐정: 흡혈괴마의 비밀,2018-02-08,2018-02-02,-6,5,5,1100,100.0,9266000,188411000,1100,26680,1,"사극,어드벤처,코미디",(주)쇼박스,남자,여자,남자,1
1708,조선명탐정: 흡혈괴마의 비밀,2018-02-08,2018-02-03,-5,14,11,2889,78.3,19762200,208173200,2263,28943,1,"사극,어드벤처,코미디",(주)쇼박스,남자,여자,남자,1
1709,조선명탐정: 흡혈괴마의 비밀,2018-02-08,2018-02-04,-4,7,7,1611,91.0,13095800,221269000,1466,30409,1,"사극,어드벤처,코미디",(주)쇼박스,남자,여자,남자,1
1710,조선명탐정: 흡혈괴마의 비밀,2018-02-08,2018-02-05,-3,10,10,1836,98.8,16172000,237441000,1814,32223,1,"사극,어드벤처,코미디",(주)쇼박스,남자,여자,남자,1
1711,조선명탐정: 흡혈괴마의 비밀,2018-02-08,2018-02-06,-2,27,27,5911,55.5,33726200,271167200,3283,35506,1,"사극,어드벤처,코미디",(주)쇼박스,남자,여자,남자,1
1712,조선명탐정: 흡혈괴마의 비밀,2018-02-08,2018-02-07,-1,1,1,140,100.0,1260000,272427200,140,35646,1,"사극,어드벤처,코미디",(주)쇼박스,남자,여자,남자,1
1713,조선명탐정: 흡혈괴마의 비밀,2018-02-08,2018-02-08,0,5972,1140,1185500,12.1,1062967600,1335394800,142796,178442,1,"사극,어드벤처,코미디",(주)쇼박스,남자,여자,남자,1
1714,조선명탐정: 흡혈괴마의 비밀,2018-02-08,2018-02-09,1,6140,1183,1216429,12.8,1269434076,2604828876,155170,333612,1,"사극,어드벤처,코미디",(주)쇼박스,남자,여자,남자,1
1715,조선명탐정: 흡혈괴마의 비밀,2018-02-08,2018-02-10,2,6608,1249,1298952,25.2,2740175669,5345004545,327600,661212,1,"사극,어드벤처,코미디",(주)쇼박스,남자,여자,남자,1
1716,조선명탐정: 흡혈괴마의 비밀,2018-02-08,2018-02-11,3,6430,1236,1264854,24.1,2526685800,7871690345,304233,965445,1,"사극,어드벤처,코미디",(주)쇼박스,남자,여자,남자,1
1717,조선명탐정: 흡혈괴마의 비밀,2018-02-08,2018-02-12,4,5887,1165,1154192,7.9,688680700,8560371045,91433,1056878,1,"사극,어드벤처,코미디",(주)쇼박스,남자,여자,남자,1
1718,조선명탐정: 흡혈괴마의 비밀,2018-02-08,2018-02-13,5,5842,1161,1149253,7.8,673731800,9234102845,89617,1146495,1,"사극,어드벤처,코미디",(주)쇼박스,남자,여자,남자,1
1719,조선명탐정: 흡혈괴마의 비밀,2018-02-08,2018-02-14,6,2387,618,345956,20.8,547907400,9782010245,72063,1218558,1,"사극,어드벤처,코미디",(주)쇼박스,남자,여자,남자,1
1720,조선명탐정: 흡혈괴마의 비밀,2018-02-08,2018-02-15,7,2492,691,359053,40.0,1214366900,10996377145,143710,1362268,1,"사극,어드벤처,코미디",(주)쇼박스,남자,여자,남자,1
1721,조선명탐정: 흡혈괴마의 비밀,2018-02-08,2018-02-16,8,2943,848,423731,54.7,1978435030,12974812175,231673,1593941,1,"사극,어드벤처,코미디",(주)쇼박스,남자,여자,남자,1
1722,조선명탐정: 흡혈괴마의 비밀,2018-02-08,2018-02-17,9,3655,1027,532784,52.7,2341744428,15316556603,280825,1874766,1,"사극,어드벤처,코미디",(주)쇼박스,남자,여자,남자,1
1723,조선명탐정: 흡혈괴마의 비밀,2018-02-08,2018-02-18,10,3573,1014,532693,37.8,1677363100,16993919703,201234,2076000,1,"사극,어드벤처,코미디",(주)쇼박스,남자,여자,남자,1
1724,조선명탐정: 흡혈괴마의 비밀,2018-02-08,2018-02-19,11,2761,710,416892,13.6,419709000,17413628703,56507,2132507,1,"사극,어드벤처,코미디",(주)쇼박스,남자,여자,남자,1
1725,조선명탐정: 흡혈괴마의 비밀,2018-02-08,2018-02-20,12,2668,726,403645,10.0,296878400,17710507103,40315,2172822,1,"사극,어드벤처,코미디",(주)쇼박스,남자,여자,남자,1
1726,조선명탐정: 흡혈괴마의 비밀,2018-02-08,2018-02-21,13,2704,719,404132,9.0,269321800,17979828903,36522,2209344,1,"사극,어드벤처,코미디",(주)쇼박스,남자,여자,남자,1
1727,조선명탐정: 흡혈괴마의 비밀,2018-02-08,2018-02-22,14,2365,645,348589,8.8,224082400,18203911303,30547,2239891,1,"사극,어드벤처,코미디",(주)쇼박스,남자,여자,남자,1
1728,조선명탐정: 흡혈괴마의 비밀,2018-02-08,2018-02-23,15,2361,636,346527,9.3,259659481,18463570784,32121,2272012,1,"사극,어드벤처,코미디",(주)쇼박스,남자,여자,남자,1
1729,조선명탐정: 흡혈괴마의 비밀,2018-02-08,2018-02-24,16,2285,634,339322,18.2,505632880,18969203664,61788,2333800,1,"사극,어드벤처,코미디",(주)쇼박스,남자,여자,남자,1
1730,조선명탐정: 흡혈괴마의 비밀,2018-02-08,2018-02-25,17,2158,624,319453,16.6,438188900,19407392564,52916,2386716,1,"사극,어드벤처,코미디",(주)쇼박스,남자,여자,남자,1
1731,조선명탐정: 흡혈괴마의 비밀,2018-02-08,2018-02-26,18,2031,559,287948,7.0,147018300,19554410864,20042,2406758,1,"사극,어드벤처,코미디",(주)쇼박스,남자,여자,남자,1
1732,조선명탐정: 흡혈괴마의 비밀,2018-02-08,2018-02-27,19,1994,573,282938,7.3,148108200,19702519064,20566,2427324,1,"사극,어드벤처,코미디",(주)쇼박스,남자,여자,남자,1
1733,조선명탐정: 흡혈괴마의 비밀,2018-02-08,2018-02-28,20,276,158,32706,11.3,22449300,19724968364,3707,2431031,1,"사극,어드벤처,코미디",(주)쇼박스,남자,여자,남자,1
1734,조선명탐정: 흡혈괴마의 비밀,2018-02-08,2018-03-01,21,237,142,27506,18.4,39173000,19764141364,5047,2436078,1,"사극,어드벤처,코미디",(주)쇼박스,남자,여자,남자,1
1735,조선명탐정: 흡혈괴마의 비밀,2018-02-08,2018-03-02,22,198,129,24006,4.2,7728400,19771869764,1005,2437083,1,"사극,어드벤처,코미디",(주)쇼박스,남자,여자,남자,1
1736,조선명탐정: 흡혈괴마의 비밀,2018-02-08,2018-03-03,23,188,127,22332,9.6,16038100,19787907864,2140,2439223,1,"사극,어드벤처,코미디",(주)쇼박스,남자,여자,남자,1
1737,조선명탐정: 흡혈괴마의 비밀,2018-02-08,2018-03-04,24,171,117,20969,8.8,14529100,19802436964,1836,2441059,1,"사극,어드벤처,코미디",(주)쇼박스,남자,여자,남자,1
1738,조선명탐정: 흡혈괴마의 비밀,2018-02-08,2018-03-05,25,138,95,17566,3.5,4361600,19806798564,620,2441679,1,"사극,어드벤처,코미디",(주)쇼박스,남자,여자,남자,1
1739,조선명탐정: 흡혈괴마의 비밀,2018-02-08,2018-03-06,26,123,88,15361,3.0,3159100,19809957664,456,2442135,1,"사극,어드벤처,코미디",(주)쇼박스,남자,여자,남자,1
1740,조선명탐정: 흡혈괴마의 비밀,2018-02-08,2018-03-07,27,49,37,6603,13.4,6379900,19816337564,882,2443017,1,"사극,어드벤처,코미디",(주)쇼박스,남자,여자,남자,1
1741,조선명탐정: 흡혈괴마의 비밀,2018-02-08,2018-03-08,28,6,4,555,3.8,146000,19816483564,21,2443038,1,"사극,어드벤처,코미디",(주)쇼박스,남자,여자,남자,1
1742,조선명탐정: 흡혈괴마의 비밀,2018-02-08,2018-03-09,29,7,4,769,3.0,212000,19816695564,23,2443061,1,"사극,어드벤처,코미디",(주)쇼박스,남자,여자,남자,1
1743,조선명탐정: 흡혈괴마의 비밀,2018-02-08,2018-03-10,30,10,6,1348,13.0,1063000,19817758564,175,2443236,1,"사극,어드벤처,코미디",(주)쇼박스,남자,여자,남자,1
1744,조선명탐정: 흡혈괴마의 비밀,2018-02-08,2018-03-11,31,11,8,1206,3.8,362000,19818120564,46,2443282,1,"사극,어드벤처,코미디",(주)쇼박스,남자,여자,남자,1
1745,조선명탐정: 흡혈괴마의 비밀,2018-02-08,2018-03-12,32,9,7,960,2.1,138600,19818259164,20,2443302,1,"사극,어드벤처,코미디",(주)쇼박스,남자,여자,남자,1
1746,조선명탐정: 흡혈괴마의 비밀,2018-02-08,2018-03-13,33,7,6,724,3.2,185600,19818444764,23,2443325,1,"사극,어드벤처,코미디",(주)쇼박스,남자,여자,남자,1
1747,조선명탐정: 흡혈괴마의 비밀,2018-02-08,2018-03-15,35,7,7,766,9.7,375000,19818819764,74,2443399,1,"사극,어드벤처,코미디",(주)쇼박스,남자,여자,남자,1
1748,조선명탐정: 흡혈괴마의 비밀,2018-02-08,2018-03-16,36,5,5,532,13.9,406000,19819225764,74,2443473,1,"사극,어드벤처,코미디",(주)쇼박스,남자,여자,남자,1
1749,조선명탐정: 흡혈괴마의 비밀,2018-02-08,2018-03-17,37,6,6,629,14.0,465000,19819690764,88,2443561,1,"사극,어드벤처,코미디",(주)쇼박스,남자,여자,남자,1
1750,조선명탐정: 흡혈괴마의 비밀,2018-02-08,2018-03-18,38,5,5,532,14.3,406000,19820096764,76,2443637,1,"사극,어드벤처,코미디",(주)쇼박스,남자,여자,남자,1
1751,조선명탐정: 흡혈괴마의 비밀,2018-02-08,2018-03-19,39,7,7,714,11.1,412000,19820508764,79,2443716,1,"사극,어드벤처,코미디",(주)쇼박스,남자,여자,남자,1
1752,조선명탐정: 흡혈괴마의 비밀,2018-02-08,2018-03-20,40,6,6,629,13.5,462000,19820970764,85,2443801,1,"사극,어드벤처,코미디",(주)쇼박스,남자,여자,남자,1
1753,조선명탐정: 흡혈괴마의 비밀,2018-02-08,2018-03-21,41,6,6,636,14.5,486000,19821456764,92,2443893,1,"사극,어드벤처,코미디",(주)쇼박스,남자,여자,남자,1
1754,조선명탐정: 흡혈괴마의 비밀,2018-02-08,2018-03-22,42,5,5,532,13.9,406000,19821862764,74,2443967,1,"사극,어드벤처,코미디",(주)쇼박스,남자,여자,남자,1
1755,조선명탐정: 흡혈괴마의 비밀,2018-02-08,2018-03-23,43,5,5,532,13.9,406000,19822268764,74,2444041,1,"사극,어드벤처,코미디",(주)쇼박스,남자,여자,남자,1
1756,조선명탐정: 흡혈괴마의 비밀,2018-02-08,2018-03-24,44,6,6,636,12.0,420000,19822688764,76,2444117,1,"사극,어드벤처,코미디",(주)쇼박스,남자,여자,남자,1
1757,조선명탐정: 흡혈괴마의 비밀,2018-02-08,2018-03-25,45,1,1,104,1.9,10000,19822698764,2,2444119,1,"사극,어드벤처,코미디",(주)쇼박스,남자,여자,남자,1
1758,조선명탐정: 흡혈괴마의 비밀,2018-02-08,2018-03-27,47,1,1,82,2.4,14000,19822712764,2,2444121,1,"사극,어드벤처,코미디",(주)쇼박스,남자,여자,남자,1
1759,조선명탐정: 흡혈괴마의 비밀,2018-02-08,2018-03-29,49,1,1,82,2.4,12000,19822724764,2,2444123,1,"사극,어드벤처,코미디",(주)쇼박스,남자,여자,남자,1
1760,조선명탐정: 흡혈괴마의 비밀,2018-02-08,2018-05-16,97,2,2,347,0.0,0,19822724764,0,2444123,1,"사극,어드벤처,코미디",(주)쇼박스,남자,여자,남자,1
1761,조선명탐정: 흡혈괴마의 비밀,2018-02-08,2018-08-30,203,1,1,278,2.2,30000,19822754764,6,2444129,1,"사극,어드벤처,코미디",(주)쇼박스,남자,여자,남자,1
1762,조선명탐정: 흡혈괴마의 비밀,2018-02-08,2018-09-03,207,1,1,278,2.5,35000,19822789764,7,2444136,1,"사극,어드벤처,코미디",(주)쇼박스,남자,여자,남자,1
1763,리틀 포레스트,2018-02-28,2018-02-13,-15,15,15,3238,100.0,21524000,21524000,3239,3239,2,드라마,메가박스중앙(주)플러스엠,여자,남자,여자,2
1764,리틀 포레스트,2018-02-28,2018-02-20,-8,40,35,8477,80.8,46692700,68216700,6846,10085,2,드라마,메가박스중앙(주)플러스엠,여자,남자,여자,2
1765,리틀 포레스트,2018-02-28,2018-02-21,-7,12,12,2740,100.0,21636000,89852700,2740,12825,2,드라마,메가박스중앙(주)플러스엠,여자,남자,여자,2
1766,리틀 포레스트,2018-02-28,2018-02-24,-4,5,2,1332,91.0,6420000,96272700,1212,14037,2,드라마,메가박스중앙(주)플러스엠,여자,남자,여자,2
1767,리틀 포레스트,2018-02-28,2018-02-25,-3,2,2,207,100.0,1559000,97831700,207,14244,2,드라마,메가박스중앙(주)플러스엠,여자,남자,여자,2
1768,리틀 포레스트,2018-02-28,2018-02-27,-1,10,10,1750,77.4,12106000,109937700,1354,15598,2,드라마,메가박스중앙(주)플러스엠,여자,남자,여자,2
1769,리틀 포레스트,2018-02-28,2018-02-28,0,4188,831,761215,17.3,779250900,889188600,131350,146948,2,드라마,메가박스중앙(주)플러스엠,여자,남자,여자,2
1770,리틀 포레스트,2018-02-28,2018-03-01,1,4274,884,782367,21.4,1385057900,2274246500,167097,314045,2,드라마,메가박스중앙(주)플러스엠,여자,남자,여자,2
1771,리틀 포레스트,2018-02-28,2018-03-02,2,4101,830,746023,10.6,658080114,2932326614,78782,392827,2,드라마,메가박스중앙(주)플러스엠,여자,남자,여자,2
1772,리틀 포레스트,2018-02-28,2018-03-03,3,3950,830,688338,22.4,1292433216,4224759830,154014,546841,2,드라마,메가박스중앙(주)플러스엠,여자,남자,여자,2
1773,리틀 포레스트,2018-02-28,2018-03-04,4,3861,833,667081,21.0,1167919900,5392679730,139732,686573,2,드라마,메가박스중앙(주)플러스엠,여자,남자,여자,2
1774,리틀 포레스트,2018-02-28,2018-03-05,5,3710,751,625077,8.1,385233100,5777912830,50835,737408,2,드라마,메가박스중앙(주)플러스엠,여자,남자,여자,2
1775,리틀 포레스트,2018-02-28,2018-03-06,6,3711,766,623848,7.7,359487700,6137400530,47876,785284,2,드라마,메가박스중앙(주)플러스엠,여자,남자,여자,2
1776,리틀 포레스트,2018-02-28,2018-03-07,7,3095,666,507066,7.9,303065600,6440466130,40047,825331,2,드라마,메가박스중앙(주)플러스엠,여자,남자,여자,2
1777,리틀 포레스트,2018-02-28,2018-03-08,8,2390,579,353463,10.0,265183900,6705650030,35210,860541,2,드라마,메가박스중앙(주)플러스엠,여자,남자,여자,2
1778,리틀 포레스트,2018-02-28,2018-03-09,9,2552,622,381358,12.8,407934330,7113584360,48732,909273,2,드라마,메가박스중앙(주)플러스엠,여자,남자,여자,2
1779,리틀 포레스트,2018-02-28,2018-03-10,10,2874,699,447386,25.7,966023320,8079607680,114883,1024156,2,드라마,메가박스중앙(주)플러스엠,여자,남자,여자,2
1780,리틀 포레스트,2018-02-28,2018-03-11,11,2800,694,436289,22.8,830372600,8909980280,99324,1123480,2,드라마,메가박스중앙(주)플러스엠,여자,남자,여자,2
1781,리틀 포레스트,2018-02-28,2018-03-12,12,2625,640,396136,7.6,226544100,9136524380,30094,1153574,2,드라마,메가박스중앙(주)플러스엠,여자,남자,여자,2
1782,리틀 포레스트,2018-02-28,2018-03-13,13,2633,655,393671,7.7,225956300,9362480680,30183,1183757,2,드라마,메가박스중앙(주)플러스엠,여자,남자,여자,2
1783,리틀 포레스트,2018-02-28,2018-03-14,14,1838,510,252176,9.1,172606900,9535087580,22905,1206662,2,드라마,메가박스중앙(주)플러스엠,여자,남자,여자,2
1784,리틀 포레스트,2018-02-28,2018-03-15,15,1758,521,243851,7.9,145160300,9680247880,19352,1226014,2,드라마,메가박스중앙(주)플러스엠,여자,남자,여자,2
1785,리틀 포레스트,2018-02-28,2018-03-16,16,1896,538,264749,10.0,222310818,9902558698,26541,1252555,2,드라마,메가박스중앙(주)플러스엠,여자,남자,여자,2
1786,리틀 포레스트,2018-02-28,2018-03-17,17,2026,584,283848,19.5,464907224,10367465922,55314,1307869,2,드라마,메가박스중앙(주)플러스엠,여자,남자,여자,2
1787,리틀 포레스트,2018-02-28,2018-03-18,18,1953,588,277233,16.5,383090300,10750556222,45707,1353576,2,드라마,메가박스중앙(주)플러스엠,여자,남자,여자,2
1788,리틀 포레스트,2018-02-28,2018-03-19,19,1784,546,251702,6.0,112879100,10863435322,15005,1368581,2,드라마,메가박스중앙(주)플러스엠,여자,남자,여자,2
1789,리틀 포레스트,2018-02-28,2018-03-20,20,1762,528,248907,5.8,107330500,10970765822,14371,1382952,2,드라마,메가박스중앙(주)플러스엠,여자,남자,여자,2
1790,리틀 포레스트,2018-02-28,2018-03-21,21,1236,514,162452,7.9,93969300,11064735122,12838,1395790,2,드라마,메가박스중앙(주)플러스엠,여자,남자,여자,2
1791,리틀 포레스트,2018-02-28,2018-03-22,22,941,430,123948,8.3,76009000,11140744122,10268,1406058,2,드라마,메가박스중앙(주)플러스엠,여자,남자,여자,2
1792,리틀 포레스트,2018-02-28,2018-03-23,23,989,459,129747,9.9,106478776,11247222898,12799,1418857,2,드라마,메가박스중앙(주)플러스엠,여자,남자,여자,2
1793,리틀 포레스트,2018-02-28,2018-03-24,24,954,466,124435,20.4,211182487,11458405385,25371,1444228,2,드라마,메가박스중앙(주)플러스엠,여자,남자,여자,2
1794,리틀 포레스트,2018-02-28,2018-03-25,25,929,458,120650,18.3,181230800,11639636185,22029,1466257,2,드라마,메가박스중앙(주)플러스엠,여자,남자,여자,2
1795,리틀 포레스트,2018-02-28,2018-03-26,26,974,448,128034,6.2,57450800,11697086985,7874,1474131,2,드라마,메가박스중앙(주)플러스엠,여자,남자,여자,2
1796,리틀 포레스트,2018-02-28,2018-03-27,27,999,458,131915,6.5,61363300,11758450285,8590,1482721,2,드라마,메가박스중앙(주)플러스엠,여자,남자,여자,2
1797,리틀 포레스트,2018-02-28,2018-03-28,28,170,126,20388,13.8,16493000,11774943285,2808,1485529,2,드라마,메가박스중앙(주)플러스엠,여자,남자,여자,2
1798,리틀 포레스트,2018-02-28,2018-03-29,29,153,114,18544,10.6,13376800,11788320085,1960,1487489,2,드라마,메가박스중앙(주)플러스엠,여자,남자,여자,2
1799,리틀 포레스트,2018-02-28,2018-03-30,30,167,124,20206,11.9,17562900,11805882985,2407,1489896,2,드라마,메가박스중앙(주)플러스엠,여자,남자,여자,2
1800,리틀 포레스트,2018-02-28,2018-03-31,31,129,92,14818,24.0,28178300,11834061285,3561,1493457,2,드라마,메가박스중앙(주)플러스엠,여자,남자,여자,2
1801,리틀 포레스트,2018-02-28,2018-04-01,32,126,88,14495,19.0,21765300,11855826585,2747,1496204,2,드라마,메가박스중앙(주)플러스엠,여자,남자,여자,2
1802,리틀 포레스트,2018-02-28,2018-04-02,33,166,112,20679,7.9,11350700,11867177285,1626,1497830,2,드라마,메가박스중앙(주)플러스엠,여자,남자,여자,2
1803,리틀 포레스트,2018-02-28,2018-04-03,34,151,105,18787,7.6,9955600,11877132885,1423,1499253,2,드라마,메가박스중앙(주)플러스엠,여자,남자,여자,2
1804,리틀 포레스트,2018-02-28,2018-04-04,35,135,94,16482,7.6,8643100,11885775985,1251,1500504,2,드라마,메가박스중앙(주)플러스엠,여자,남자,여자,2
1805,리틀 포레스트,2018-02-28,2018-04-05,36,30,23,3799,14.1,3569400,11889345385,535,1501039,2,드라마,메가박스중앙(주)플러스엠,여자,남자,여자,2
1806,리틀 포레스트,2018-02-28,2018-04-06,37,31,24,3860,11.3,3406900,11892752285,436,1501475,2,드라마,메가박스중앙(주)플러스엠,여자,남자,여자,2
1807,리틀 포레스트,2018-02-28,2018-04-07,38,29,23,3729,11.0,3520700,11896272985,411,1501886,2,드라마,메가박스중앙(주)플러스엠,여자,남자,여자,2
1808,리틀 포레스트,2018-02-28,2018-04-08,39,25,18,3020,18.7,4806400,11901079385,565,1502451,2,드라마,메가박스중앙(주)플러스엠,여자,남자,여자,2
1809,리틀 포레스트,2018-02-28,2018-04-09,40,32,25,4447,4.9,1608600,11902687985,218,1502669,2,드라마,메가박스중앙(주)플러스엠,여자,남자,여자,2
1810,리틀 포레스트,2018-02-28,2018-04-10,41,32,25,4391,4.2,1341700,11904029685,186,1502855,2,드라마,메가박스중앙(주)플러스엠,여자,남자,여자,2
1811,리틀 포레스트,2018-02-28,2018-04-11,42,28,26,3843,5.4,1558100,11905587785,206,1503061,2,드라마,메가박스중앙(주)플러스엠,여자,남자,여자,2
1812,리틀 포레스트,2018-02-28,2018-04-12,43,4,3,245,9.8,181500,11905769285,24,1503085,2,드라마,메가박스중앙(주)플러스엠,여자,남자,여자,2
1813,리틀 포레스트,2018-02-28,2018-04-13,44,7,5,799,19.0,1083100,11906852385,152,1503237,2,드라마,메가박스중앙(주)플러스엠,여자,남자,여자,2
1814,리틀 포레스트,2018-02-28,2018-04-14,45,9,7,820,20.7,1532600,11908384985,170,1503407,2,드라마,메가박스중앙(주)플러스엠,여자,남자,여자,2
1815,리틀 포레스트,2018-02-28,2018-04-15,46,6,4,696,15.4,958700,11909343685,107,1503514,2,드라마,메가박스중앙(주)플러스엠,여자,남자,여자,2
1816,리틀 포레스트,2018-02-28,2018-04-16,47,8,5,1338,5.7,534000,11909877685,76,1503590,2,드라마,메가박스중앙(주)플러스엠,여자,남자,여자,2
1817,리틀 포레스트,2018-02-28,2018-04-17,48,6,4,1044,4.4,395000,11910272685,46,1503636,2,드라마,메가박스중앙(주)플러스엠,여자,남자,여자,2
1818,리틀 포레스트,2018-02-28,2018-04-18,49,7,5,1218,6.2,535600,11910808285,75,1503711,2,드라마,메가박스중앙(주)플러스엠,여자,남자,여자,2
1819,리틀 포레스트,2018-02-28,2018-04-19,50,3,1,600,5.0,247500,11911055785,30,1503741,2,드라마,메가박스중앙(주)플러스엠,여자,남자,여자,2
1820,리틀 포레스트,2018-02-28,2018-04-20,51,5,3,965,3.6,361500,11911417285,35,1503776,2,드라마,메가박스중앙(주)플러스엠,여자,남자,여자,2
1821,리틀 포레스트,2018-02-28,2018-04-21,52,4,2,427,11.9,464000,11911881285,51,1503827,2,드라마,메가박스중앙(주)플러스엠,여자,남자,여자,2
1822,리틀 포레스트,2018-02-28,2018-04-22,53,4,4,492,8.1,344900,11912226185,40,1503867,2,드라마,메가박스중앙(주)플러스엠,여자,남자,여자,2
1823,리틀 포레스트,2018-02-28,2018-04-23,54,5,4,806,2.9,181500,11912407685,23,1503890,2,드라마,메가박스중앙(주)플러스엠,여자,남자,여자,2
1824,리틀 포레스트,2018-02-28,2018-04-24,55,6,4,997,4.0,339500,11912747185,40,1503930,2,드라마,메가박스중앙(주)플러스엠,여자,남자,여자,2
1825,리틀 포레스트,2018-02-28,2018-04-25,56,3,3,220,59.1,684000,11913431185,130,1504060,2,드라마,메가박스중앙(주)플러스엠,여자,남자,여자,2
1826,리틀 포레스트,2018-02-28,2018-04-27,58,1,1,135,66.7,540000,11913971185,90,1504150,2,드라마,메가박스중앙(주)플러스엠,여자,남자,여자,2
1827,리틀 포레스트,2018-02-28,2018-04-28,59,1,1,40,35.0,84000,11914055185,14,1504164,2,드라마,메가박스중앙(주)플러스엠,여자,남자,여자,2
1828,리틀 포레스트,2018-02-28,2018-04-29,60,1,1,40,22.5,54000,11914109185,9,1504173,2,드라마,메가박스중앙(주)플러스엠,여자,남자,여자,2
1829,리틀 포레스트,2018-02-28,2018-04-30,61,2,2,99,33.3,272000,11914381185,33,1504206,2,드라마,메가박스중앙(주)플러스엠,여자,남자,여자,2
1830,리틀 포레스트,2018-02-28,2018-05-01,62,1,1,40,97.5,308000,11914689185,39,1504245,2,드라마,메가박스중앙(주)플러스엠,여자,남자,여자,2
1831,리틀 포레스트,2018-02-28,2018-05-07,68,1,1,59,23.7,139000,11914828185,14,1504259,2,드라마,메가박스중앙(주)플러스엠,여자,남자,여자,2
1832,리틀 포레스트,2018-02-28,2018-05-08,69,1,1,59,3.4,20000,11914848185,2,1504261,2,드라마,메가박스중앙(주)플러스엠,여자,남자,여자,2
1833,리틀 포레스트,2018-02-28,2018-05-09,70,1,1,59,10.2,60000,11914908185,6,1504267,2,드라마,메가박스중앙(주)플러스엠,여자,남자,여자,2
1834,리틀 포레스트,2018-02-28,2018-05-10,71,1,1,32,100.0,288000,11915196185,32,1504299,2,드라마,메가박스중앙(주)플러스엠,여자,남자,여자,2
1835,리틀 포레스트,2018-02-28,2018-05-14,75,1,1,59,1.7,10000,11915206185,1,1504300,2,드라마,메가박스중앙(주)플러스엠,여자,남자,여자,2
1836,리틀 포레스트,2018-02-28,2018-05-15,76,1,1,154,29.2,315000,11915521185,45,1504345,2,드라마,메가박스중앙(주)플러스엠,여자,남자,여자,2
1837,리틀 포레스트,2018-02-28,2018-05-16,77,1,1,59,3.4,20000,11915541185,2,1504347,2,드라마,메가박스중앙(주)플러스엠,여자,남자,여자,2
1838,리틀 포레스트,2018-02-28,2018-05-19,80,1,1,103,21.4,110000,11915651185,22,1504369,2,드라마,메가박스중앙(주)플러스엠,여자,남자,여자,2
1839,리틀 포레스트,2018-02-28,2018-05-21,82,1,1,59,5.1,30000,11915681185,3,1504372,2,드라마,메가박스중앙(주)플러스엠,여자,남자,여자,2
1840,리틀 포레스트,2018-02-28,2018-05-22,83,2,2,261,18.0,292000,11915973185,47,1504419,2,드라마,메가박스중앙(주)플러스엠,여자,남자,여자,2
1841,리틀 포레스트,2018-02-28,2018-05-23,84,1,1,59,10.2,60000,11916033185,6,1504425,2,드라마,메가박스중앙(주)플러스엠,여자,남자,여자,2
1842,리틀 포레스트,2018-02-28,2018-05-29,90,1,1,59,1.7,10000,11916043185,1,1504426,2,드라마,메가박스중앙(주)플러스엠,여자,남자,여자,2
1843,리틀 포레스트,2018-02-28,2018-05-30,91,1,1,64,78.1,450000,11916493185,50,1504476,2,드라마,메가박스중앙(주)플러스엠,여자,남자,여자,2
1844,리틀 포레스트,2018-02-28,2018-05-31,92,1,1,90,77.8,490000,11916983185,70,1504546,2,드라마,메가박스중앙(주)플러스엠,여자,남자,여자,2
1845,리틀 포레스트,2018-02-28,2018-06-04,96,1,1,114,100.0,800000,11917783185,114,1504660,2,드라마,메가박스중앙(주)플러스엠,여자,남자,여자,2
1846,리틀 포레스트,2018-02-28,2018-06-23,115,1,1,413,14.5,384000,11918167185,60,1504720,2,드라마,메가박스중앙(주)플러스엠,여자,남자,여자,2
1847,리틀 포레스트,2018-02-28,2018-06-24,116,1,1,841,5.8,317000,11918484185,49,1504769,2,드라마,메가박스중앙(주)플러스엠,여자,남자,여자,2
1848,리틀 포레스트,2018-02-28,2018-06-27,119,1,1,97,100.0,1261000,11919745185,97,1504866,2,드라마,메가박스중앙(주)플러스엠,여자,남자,여자,2
1849,리틀 포레스트,2018-02-28,2018-07-03,125,1,1,72,0.0,0,11919745185,0,1504866,2,드라마,메가박스중앙(주)플러스엠,여자,남자,여자,2
1850,리틀 포레스트,2018-02-28,2018-07-04,126,1,1,158,100.0,1264000,11921009185,158,1505024,2,드라마,메가박스중앙(주)플러스엠,여자,남자,여자,2
1851,리틀 포레스트,2018-02-28,2018-07-05,127,1,1,72,0.0,0,11921009185,0,1505024,2,드라마,메가박스중앙(주)플러스엠,여자,남자,여자,2
1852,리틀 포레스트,2018-02-28,2018-07-06,128,1,1,123,0.0,0,11921009185,0,1505024,2,드라마,메가박스중앙(주)플러스엠,여자,남자,여자,2
1853,리틀 포레스트,2018-02-28,2018-07-07,129,1,1,83,100.0,913000,11921922185,83,1505107,2,드라마,메가박스중앙(주)플러스엠,여자,남자,여자,2
1854,리틀 포레스트,2018-02-28,2018-07-10,132,3,2,141,100.0,725000,11922647185,141,1505248,2,드라마,메가박스중앙(주)플러스엠,여자,남자,여자,2
1855,리틀 포레스트,2018-02-28,2018-07-19,141,1,1,273,72.5,1188000,11923835185,198,1505446,2,드라마,메가박스중앙(주)플러스엠,여자,남자,여자,2
1856,리틀 포레스트,2018-02-28,2018-07-27,149,1,1,123,35.8,440000,11924275185,44,1505490,2,드라마,메가박스중앙(주)플러스엠,여자,남자,여자,2
1857,리틀 포레스트,2018-02-28,2018-08-11,164,1,1,202,34.7,543000,11924818185,70,1505560,2,드라마,메가박스중앙(주)플러스엠,여자,남자,여자,2
1858,리틀 포레스트,2018-02-28,2018-09-17,201,1,1,160,101.3,972000,11925790185,162,1505722,2,드라마,메가박스중앙(주)플러스엠,여자,남자,여자,2
1859,리틀 포레스트,2018-02-28,2018-10-17,231,1,1,293,3.4,90000,11925880185,10,1505732,2,드라마,메가박스중앙(주)플러스엠,여자,남자,여자,2
1860,리틀 포레스트,2018-02-28,2018-10-24,238,1,1,106,94.3,700000,11926580185,100,1505832,2,드라마,메가박스중앙(주)플러스엠,여자,남자,여자,2
1861,리틀 포레스트,2018-02-28,2018-10-29,243,1,1,92,21.7,140000,11926720185,20,1505852,2,드라마,메가박스중앙(주)플러스엠,여자,남자,여자,2
1862,리틀 포레스트,2018-02-28,2018-11-14,259,1,1,85,0.0,0,11926720185,0,1505852,2,드라마,메가박스중앙(주)플러스엠,여자,남자,여자,2
1863,리틀 포레스트,2018-02-28,2018-12-07,282,2,1,174,83.3,870000,11927590185,145,1505997,2,드라마,메가박스중앙(주)플러스엠,여자,남자,여자,2
1864,리틀 포레스트,2018-02-28,2018-12-13,288,1,1,413,3.9,80000,11927670185,16,1506013,2,드라마,메가박스중앙(주)플러스엠,여자,남자,여자,2
1865,리틀 포레스트,2018-02-28,2018-12-14,289,1,1,413,51.8,1070000,11928740185,214,1506227,2,드라마,메가박스중앙(주)플러스엠,여자,남자,여자,2
1866,리틀 포레스트,2018-02-28,2018-12-15,290,1,1,42,100.0,462000,11929202185,42,1506269,2,드라마,메가박스중앙(주)플러스엠,여자,남자,여자,2
1867,리틀 포레스트,2018-02-28,2019-01-22,328,4,4,522,46.0,1745000,11930947185,240,1506509,2,드라마,메가박스중앙(주)플러스엠,여자,남자,여자,2
1868,리틀 포레스트,2018-02-28,2019-03-15,380,1,1,169,88.8,1050000,11931997185,150,1506659,2,드라마,메가박스중앙(주)플러스엠,여자,남자,여자,2
1869,리틀 포레스트,2018-02-28,2019-04-04,400,1,1,22,100.0,176000,11932173185,22,1506681,2,드라마,메가박스중앙(주)플러스엠,여자,남자,여자,2
1870,리틀 포레스트,2018-02-28,2019-04-21,417,1,1,174,100.0,1740000,11933913185,174,1506855,2,드라마,메가박스중앙(주)플러스엠,여자,남자,여자,2
1871,리틀 포레스트,2018-02-28,2019-06-22,479,1,1,55,101.8,336000,11934249185,56,1506911,2,드라마,메가박스중앙(주)플러스엠,여자,남자,여자,2
1872,사라진 밤,2018-03-07,2018-02-22,-13,1,1,208,100.0,1664000,1664000,208,208,0,스릴러,씨네그루(주)키다리이엔티,남자,남자,남자,0
1873,사라진 밤,2018-03-07,2018-02-28,-7,6,6,1256,99.0,9920000,11584000,1244,1452,0,스릴러,씨네그루(주)키다리이엔티,남자,남자,남자,0
1874,사라진 밤,2018-03-07,2018-03-05,-2,12,12,2968,94.2,19392000,30976000,2795,4247,0,스릴러,씨네그루(주)키다리이엔티,남자,남자,남자,0
1875,사라진 밤,2018-03-07,2018-03-06,-1,33,33,5374,74.0,31066900,62042900,3976,8223,0,스릴러,씨네그루(주)키다리이엔티,남자,남자,남자,0
1876,사라진 밤,2018-03-07,2018-03-07,0,3386,697,549374,10.4,438121700,500164600,57161,65384,0,스릴러,씨네그루(주)키다리이엔티,남자,남자,남자,0
1877,사라진 밤,2018-03-07,2018-03-08,1,2996,608,481960,13.5,497039400,997204000,65087,130471,0,스릴러,씨네그루(주)키다리이엔티,남자,남자,남자,0
1878,사라진 밤,2018-03-07,2018-03-09,2,3207,683,517867,17.6,769400659,1766604659,91236,221707,0,스릴러,씨네그루(주)키다리이엔티,남자,남자,남자,0
1879,사라진 밤,2018-03-07,2018-03-10,3,3910,857,668120,33.3,1878100468,3644705127,222771,444478,0,스릴러,씨네그루(주)키다리이엔티,남자,남자,남자,0
1880,사라진 밤,2018-03-07,2018-03-11,4,3991,925,689103,30.4,1767419500,5412124627,209500,653978,0,스릴러,씨네그루(주)키다리이엔티,남자,남자,남자,0
1881,사라진 밤,2018-03-07,2018-03-12,5,3746,790,661006,9.1,458747000,5870871627,59935,713913,0,스릴러,씨네그루(주)키다리이엔티,남자,남자,남자,0
1882,사라진 밤,2018-03-07,2018-03-13,6,3753,800,664600,8.2,416611400,6287483027,54522,768435,0,스릴러,씨네그루(주)키다리이엔티,남자,남자,남자,0
1883,사라진 밤,2018-03-07,2018-03-14,7,3151,675,512992,9.6,376754000,6664237027,49340,817775,0,스릴러,씨네그루(주)키다리이엔티,남자,남자,남자,0
1884,사라진 밤,2018-03-07,2018-03-15,8,3076,652,500347,7.9,298371100,6962608127,39473,857248,0,스릴러,씨네그루(주)키다리이엔티,남자,남자,남자,0
1885,사라진 밤,2018-03-07,2018-03-16,9,3227,683,523917,9.5,413970807,7376578934,49664,906912,0,스릴러,씨네그루(주)키다리이엔티,남자,남자,남자,0
1886,사라진 밤,2018-03-07,2018-03-17,10,3487,777,564080,19.6,923480403,8300059337,110296,1017208,0,스릴러,씨네그루(주)키다리이엔티,남자,남자,남자,0
1887,사라진 밤,2018-03-07,2018-03-18,11,3358,749,543301,16.9,775101900,9075161237,91943,1109151,0,스릴러,씨네그루(주)키다리이엔티,남자,남자,남자,0
1888,사라진 밤,2018-03-07,2018-03-19,12,2971,684,469163,5.8,206959800,9282121037,27408,1136559,0,스릴러,씨네그루(주)키다리이엔티,남자,남자,남자,0
1889,사라진 밤,2018-03-07,2018-03-20,13,2891,677,461432,5.2,180601900,9462722937,23879,1160438,0,스릴러,씨네그루(주)키다리이엔티,남자,남자,남자,0
1890,사라진 밤,2018-03-07,2018-03-21,14,1982,590,277656,6.9,144591200,9607314137,19194,1179632,0,스릴러,씨네그루(주)키다리이엔티,남자,남자,남자,0
1891,사라진 밤,2018-03-07,2018-03-22,15,1729,523,237472,6.6,119010600,9726324737,15735,1195367,0,스릴러,씨네그루(주)키다리이엔티,남자,남자,남자,0
1892,사라진 밤,2018-03-07,2018-03-23,16,1751,535,238143,8.5,166519389,9892844126,20242,1215609,0,스릴러,씨네그루(주)키다리이엔티,남자,남자,남자,0
1893,사라진 밤,2018-03-07,2018-03-24,17,1637,540,220318,17.9,325863890,10218708016,39530,1255139,0,스릴러,씨네그루(주)키다리이엔티,남자,남자,남자,0
1894,사라진 밤,2018-03-07,2018-03-25,18,1546,542,207107,15.9,272489300,10491197316,32858,1287997,0,스릴러,씨네그루(주)키다리이엔티,남자,남자,남자,0
1895,사라진 밤,2018-03-07,2018-03-26,19,1544,504,207423,5.4,84419200,10575616516,11187,1299184,0,스릴러,씨네그루(주)키다리이엔티,남자,남자,남자,0
1896,사라진 밤,2018-03-07,2018-03-27,20,1513,509,203816,5.2,78631500,10654248016,10577,1309761,0,스릴러,씨네그루(주)키다리이엔티,남자,남자,남자,0
1897,사라진 밤,2018-03-07,2018-03-28,21,200,134,23148,5.2,7457800,10661705816,1198,1310959,0,스릴러,씨네그루(주)키다리이엔티,남자,남자,남자,0
1898,사라진 밤,2018-03-07,2018-03-29,22,180,124,21702,3.7,5717100,10667422916,799,1311758,0,스릴러,씨네그루(주)키다리이엔티,남자,남자,남자,0
1899,사라진 밤,2018-03-07,2018-03-30,23,176,126,20954,3.9,6597700,10674020616,808,1312566,0,스릴러,씨네그루(주)키다리이엔티,남자,남자,남자,0
1900,사라진 밤,2018-03-07,2018-03-31,24,133,94,14839,6.9,8218300,10682238916,1029,1313595,0,스릴러,씨네그루(주)키다리이엔티,남자,남자,남자,0
1901,사라진 밤,2018-03-07,2018-04-01,25,105,84,12133,5.9,5783200,10688022116,713,1314308,0,스릴러,씨네그루(주)키다리이엔티,남자,남자,남자,0
1902,사라진 밤,2018-03-07,2018-04-02,26,100,76,11440,2.9,2402000,10690424116,328,1314636,0,스릴러,씨네그루(주)키다리이엔티,남자,남자,남자,0
1903,사라진 밤,2018-03-07,2018-04-03,27,110,81,12985,2.6,2416400,10692840516,335,1314971,0,스릴러,씨네그루(주)키다리이엔티,남자,남자,남자,0
1904,사라진 밤,2018-03-07,2018-04-04,28,66,50,8599,3.0,1886800,10694727316,260,1315231,0,스릴러,씨네그루(주)키다리이엔티,남자,남자,남자,0
1905,사라진 밤,2018-03-07,2018-04-06,30,2,2,351,0.6,2000,10694729316,2,1315233,0,스릴러,씨네그루(주)키다리이엔티,남자,남자,남자,0
1906,사라진 밤,2018-03-07,2018-04-07,31,2,2,296,0.7,2000,10694731316,2,1315235,0,스릴러,씨네그루(주)키다리이엔티,남자,남자,남자,0
1907,사라진 밤,2018-03-07,2018-04-08,32,2,2,296,0.7,2000,10694733316,2,1315237,0,스릴러,씨네그루(주)키다리이엔티,남자,남자,남자,0
1908,사라진 밤,2018-03-07,2018-04-09,33,2,2,296,0.7,2000,10694735316,2,1315239,0,스릴러,씨네그루(주)키다리이엔티,남자,남자,남자,0
1909,사라진 밤,2018-03-07,2018-04-10,34,2,2,296,0.7,2000,10694737316,2,1315241,0,스릴러,씨네그루(주)키다리이엔티,남자,남자,남자,0
1910,사라진 밤,2018-03-07,2018-04-11,35,2,2,296,0.7,2000,10694739316,2,1315243,0,스릴러,씨네그루(주)키다리이엔티,남자,남자,남자,0
1911,사라진 밤,2018-03-07,2018-04-12,36,5,5,521,1.0,7000,10694746316,5,1315248,0,스릴러,씨네그루(주)키다리이엔티,남자,남자,남자,0
1912,사라진 밤,2018-03-07,2018-04-13,37,5,5,521,1.0,8000,10694754316,5,1315253,0,스릴러,씨네그루(주)키다리이엔티,남자,남자,남자,0
1913,사라진 밤,2018-03-07,2018-04-14,38,5,5,521,1.0,8000,10694762316,5,1315258,0,스릴러,씨네그루(주)키다리이엔티,남자,남자,남자,0
1914,사라진 밤,2018-03-07,2018-04-15,39,5,5,521,1.0,8000,10694770316,5,1315263,0,스릴러,씨네그루(주)키다리이엔티,남자,남자,남자,0
1915,사라진 밤,2018-03-07,2018-04-17,41,4,4,462,0.9,6000,10694776316,4,1315267,0,스릴러,씨네그루(주)키다리이엔티,남자,남자,남자,0
1916,사라진 밤,2018-03-07,2018-04-18,42,6,6,910,43.0,3096000,10697872316,391,1315658,0,스릴러,씨네그루(주)키다리이엔티,남자,남자,남자,0
1917,사라진 밤,2018-03-07,2018-04-19,43,5,5,521,1.0,8000,10697880316,5,1315663,0,스릴러,씨네그루(주)키다리이엔티,남자,남자,남자,0
1918,사라진 밤,2018-03-07,2018-04-20,44,5,5,521,1.0,8000,10697888316,5,1315668,0,스릴러,씨네그루(주)키다리이엔티,남자,남자,남자,0
1919,사라진 밤,2018-03-07,2018-04-21,45,5,5,521,1.0,8000,10697896316,5,1315673,0,스릴러,씨네그루(주)키다리이엔티,남자,남자,남자,0
1920,사라진 밤,2018-03-07,2018-04-22,46,5,5,521,1.0,8000,10697904316,5,1315678,0,스릴러,씨네그루(주)키다리이엔티,남자,남자,남자,0
1921,사라진 밤,2018-03-07,2018-04-23,47,6,6,743,0.7,8000,10697912316,5,1315683,0,스릴러,씨네그루(주)키다리이엔티,남자,남자,남자,0
1922,사라진 밤,2018-03-07,2018-04-24,48,4,4,581,0.5,5000,10697917316,3,1315686,0,스릴러,씨네그루(주)키다리이엔티,남자,남자,남자,0
1923,사라진 밤,2018-03-07,2018-04-25,49,5,5,564,0.9,8000,10697925316,5,1315691,0,스릴러,씨네그루(주)키다리이엔티,남자,남자,남자,0
1924,사라진 밤,2018-03-07,2018-04-26,50,5,5,564,0.9,8000,10697933316,5,1315696,0,스릴러,씨네그루(주)키다리이엔티,남자,남자,남자,0
1925,사라진 밤,2018-03-07,2018-04-27,51,5,5,564,0.9,8000,10697941316,5,1315701,0,스릴러,씨네그루(주)키다리이엔티,남자,남자,남자,0
1926,사라진 밤,2018-03-07,2018-04-28,52,5,5,564,0.9,8000,10697949316,5,1315706,0,스릴러,씨네그루(주)키다리이엔티,남자,남자,남자,0
1927,사라진 밤,2018-03-07,2018-04-29,53,5,5,564,0.9,8000,10697957316,5,1315711,0,스릴러,씨네그루(주)키다리이엔티,남자,남자,남자,0
1928,사라진 밤,2018-03-07,2018-04-30,54,5,5,564,0.9,8000,10697965316,5,1315716,0,스릴러,씨네그루(주)키다리이엔티,남자,남자,남자,0
1929,사라진 밤,2018-03-07,2018-05-01,55,5,5,564,0.9,8000,10697973316,5,1315721,0,스릴러,씨네그루(주)키다리이엔티,남자,남자,남자,0
1930,사라진 밤,2018-03-07,2018-05-02,56,5,5,564,0.9,8000,10697981316,5,1315726,0,스릴러,씨네그루(주)키다리이엔티,남자,남자,남자,0
1931,사라진 밤,2018-03-07,2018-07-05,120,1,1,108,0.0,0,10697981316,0,1315726,0,스릴러,씨네그루(주)키다리이엔티,남자,남자,남자,0
1932,지금 만나러 갑니다,2018-03-14,2018-03-01,-13,3,1,780,11.7,182000,182000,91,91,0,멜로/로맨스,롯데컬처웍스(주)롯데엔터테인먼트,남자,남자,남자,0
1933,지금 만나러 갑니다,2018-03-14,2018-03-02,-12,3,1,780,8.5,132000,314000,66,157,0,멜로/로맨스,롯데컬처웍스(주)롯데엔터테인먼트,남자,남자,남자,0
1934,지금 만나러 갑니다,2018-03-14,2018-03-05,-9,1,1,401,100.0,3208000,3522000,401,558,0,멜로/로맨스,롯데컬처웍스(주)롯데엔터테인먼트,남자,남자,남자,0
1935,지금 만나러 갑니다,2018-03-14,2018-03-06,-8,32,31,6745,88.1,47170500,50692500,5945,6503,0,멜로/로맨스,롯데컬처웍스(주)롯데엔터테인먼트,남자,남자,남자,0
1936,지금 만나러 갑니다,2018-03-14,2018-03-07,-7,9,9,1989,99.4,14039000,64731500,1976,8479,0,멜로/로맨스,롯데컬처웍스(주)롯데엔터테인먼트,남자,남자,남자,0
1937,지금 만나러 갑니다,2018-03-14,2018-03-08,-6,18,18,3284,96.4,23656000,88387500,3166,11645,0,멜로/로맨스,롯데컬처웍스(주)롯데엔터테인먼트,남자,남자,남자,0
1938,지금 만나러 갑니다,2018-03-14,2018-03-09,-5,8,8,2192,95.9,19468000,107855500,2102,13747,0,멜로/로맨스,롯데컬처웍스(주)롯데엔터테인먼트,남자,남자,남자,0
1939,지금 만나러 갑니다,2018-03-14,2018-03-12,-2,21,20,4851,98.8,37421000,145276500,4793,18540,0,멜로/로맨스,롯데컬처웍스(주)롯데엔터테인먼트,남자,남자,남자,0
1940,지금 만나러 갑니다,2018-03-14,2018-03-13,-1,35,35,5904,68.4,30322100,175598600,4040,22580,0,멜로/로맨스,롯데컬처웍스(주)롯데엔터테인먼트,남자,남자,남자,0
1941,지금 만나러 갑니다,2018-03-14,2018-03-14,0,4276,990,803374,11.2,682198900,857797500,89772,112352,0,멜로/로맨스,롯데컬처웍스(주)롯데엔터테인먼트,남자,남자,남자,0
1942,지금 만나러 갑니다,2018-03-14,2018-03-15,1,4317,1020,810633,10.5,641685700,1499483200,85399,197751,0,멜로/로맨스,롯데컬처웍스(주)롯데엔터테인먼트,남자,남자,남자,0
1943,지금 만나러 갑니다,2018-03-14,2018-03-16,2,4579,1051,859861,14.6,1048910675,2548393875,125650,323401,0,멜로/로맨스,롯데컬처웍스(주)롯데엔터테인먼트,남자,남자,남자,0
1944,지금 만나러 갑니다,2018-03-14,2018-03-17,3,5151,1163,963726,29.6,2403593173,4951987048,285322,608723,0,멜로/로맨스,롯데컬처웍스(주)롯데엔터테인먼트,남자,남자,남자,0
1945,지금 만나러 갑니다,2018-03-14,2018-03-18,4,5066,1163,952176,28.6,2295273100,7247260148,272180,880903,0,멜로/로맨스,롯데컬처웍스(주)롯데엔터테인먼트,남자,남자,남자,0
1946,지금 만나러 갑니다,2018-03-14,2018-03-19,5,4718,1087,887859,11.3,752733300,7999993448,99894,980797,0,멜로/로맨스,롯데컬처웍스(주)롯데엔터테인먼트,남자,남자,남자,0
1947,지금 만나러 갑니다,2018-03-14,2018-03-20,6,4693,1092,885189,10.7,709021900,8709015348,94239,1075036,0,멜로/로맨스,롯데컬처웍스(주)롯데엔터테인먼트,남자,남자,남자,0
1948,지금 만나러 갑니다,2018-03-14,2018-03-21,7,3809,1003,610761,14.4,666833400,9375848748,88210,1163246,0,멜로/로맨스,롯데컬처웍스(주)롯데엔터테인먼트,남자,남자,남자,0
1949,지금 만나러 갑니다,2018-03-14,2018-03-22,8,3996,961,643670,13.0,626521300,10002370048,83417,1246663,0,멜로/로맨스,롯데컬처웍스(주)롯데엔터테인먼트,남자,남자,남자,0
1950,지금 만나러 갑니다,2018-03-14,2018-03-23,9,4315,1035,697894,16.4,949823135,10952193183,114375,1361038,0,멜로/로맨스,롯데컬처웍스(주)롯데엔터테인먼트,남자,남자,남자,0
1951,지금 만나러 갑니다,2018-03-14,2018-03-24,10,5061,1191,839383,29.4,2059112723,13011305906,247062,1608100,0,멜로/로맨스,롯데컬처웍스(주)롯데엔터테인먼트,남자,남자,남자,0
1952,지금 만나러 갑니다,2018-03-14,2018-03-25,11,4968,1164,828994,26.0,1802271850,14813577756,215646,1823746,0,멜로/로맨스,롯데컬처웍스(주)롯데엔터테인먼트,남자,남자,남자,0
1953,지금 만나러 갑니다,2018-03-14,2018-03-26,12,4524,1047,756190,8.6,485862300,15299440056,64727,1888473,0,멜로/로맨스,롯데컬처웍스(주)롯데엔터테인먼트,남자,남자,남자,0
1954,지금 만나러 갑니다,2018-03-14,2018-03-27,13,4531,1072,752655,8.4,471103400,15770543456,63258,1951731,0,멜로/로맨스,롯데컬처웍스(주)롯데엔터테인먼트,남자,남자,남자,0
1955,지금 만나러 갑니다,2018-03-14,2018-03-28,14,2405,701,352757,21.6,436023800,16206567256,76162,2027893,0,멜로/로맨스,롯데컬처웍스(주)롯데엔터테인먼트,남자,남자,남자,0
1956,지금 만나러 갑니다,2018-03-14,2018-03-29,15,2420,677,349761,11.4,296742400,16503309656,40017,2067910,0,멜로/로맨스,롯데컬처웍스(주)롯데엔터테인먼트,남자,남자,남자,0
1957,지금 만나러 갑니다,2018-03-14,2018-03-30,16,2570,708,368525,14.7,442375225,16945684881,54151,2122061,0,멜로/로맨스,롯데컬처웍스(주)롯데엔터테인먼트,남자,남자,남자,0
1958,지금 만나러 갑니다,2018-03-14,2018-03-31,17,2682,736,383429,28.3,896251122,17841936003,108358,2230419,0,멜로/로맨스,롯데컬처웍스(주)롯데엔터테인먼트,남자,남자,남자,0
1959,지금 만나러 갑니다,2018-03-14,2018-04-01,18,2587,735,372806,24.4,749560000,18591496003,90812,2321231,0,멜로/로맨스,롯데컬처웍스(주)롯데엔터테인먼트,남자,남자,남자,0
1960,지금 만나러 갑니다,2018-03-14,2018-04-02,19,2439,654,343494,8.3,210665700,18802161703,28444,2349675,0,멜로/로맨스,롯데컬처웍스(주)롯데엔터테인먼트,남자,남자,남자,0
1961,지금 만나러 갑니다,2018-03-14,2018-04-03,20,2426,681,338174,7.6,190049400,18992211103,25784,2375459,0,멜로/로맨스,롯데컬처웍스(주)롯데엔터테인먼트,남자,남자,남자,0
1962,지금 만나러 갑니다,2018-03-14,2018-04-04,21,2380,665,322837,8.7,208591900,19200803003,28134,2403593,0,멜로/로맨스,롯데컬처웍스(주)롯데엔터테인먼트,남자,남자,남자,0
1963,지금 만나러 갑니다,2018-03-14,2018-04-05,22,1631,507,215064,9.2,146223900,19347026903,19801,2423394,0,멜로/로맨스,롯데컬처웍스(주)롯데엔터테인먼트,남자,남자,남자,0
1964,지금 만나러 갑니다,2018-03-14,2018-04-06,23,1652,528,218363,11.5,206732118,19553759021,25202,2448596,0,멜로/로맨스,롯데컬처웍스(주)롯데엔터테인먼트,남자,남자,남자,0
1965,지금 만나러 갑니다,2018-03-14,2018-04-07,24,1482,530,187806,22.6,357654807,19911413828,42484,2491080,0,멜로/로맨스,롯데컬처웍스(주)롯데엔터테인먼트,남자,남자,남자,0
1966,지금 만나러 갑니다,2018-03-14,2018-04-08,25,1417,521,179316,19.3,291420500,20202834328,34655,2525735,0,멜로/로맨스,롯데컬처웍스(주)롯데엔터테인먼트,남자,남자,남자,0
1967,지금 만나러 갑니다,2018-03-14,2018-04-09,26,1454,484,189741,6.3,88909200,20291743528,11969,2537704,0,멜로/로맨스,롯데컬처웍스(주)롯데엔터테인먼트,남자,남자,남자,0
1968,지금 만나러 갑니다,2018-03-14,2018-04-10,27,1428,495,189427,5.9,82983100,20374726628,11241,2548945,0,멜로/로맨스,롯데컬처웍스(주)롯데엔터테인먼트,남자,남자,남자,0
1969,지금 만나러 갑니다,2018-03-14,2018-04-11,28,1406,479,185642,6.3,89537800,20464264428,11675,2560620,0,멜로/로맨스,롯데컬처웍스(주)롯데엔터테인먼트,남자,남자,남자,0
1970,지금 만나러 갑니다,2018-03-14,2018-04-12,29,384,222,48648,8.4,30689900,20494954328,4104,2564724,0,멜로/로맨스,롯데컬처웍스(주)롯데엔터테인먼트,남자,남자,남자,0
1971,지금 만나러 갑니다,2018-03-14,2018-04-13,30,368,219,46038,11.9,44920500,20539874828,5468,2570192,0,멜로/로맨스,롯데컬처웍스(주)롯데엔터테인먼트,남자,남자,남자,0
1972,지금 만나러 갑니다,2018-03-14,2018-04-14,31,316,203,37802,24.7,80682900,20620557728,9325,2579517,0,멜로/로맨스,롯데컬처웍스(주)롯데엔터테인먼트,남자,남자,남자,0
1973,지금 만나러 갑니다,2018-03-14,2018-04-15,32,308,198,36786,18.8,59145500,20679703228,6923,2586440,0,멜로/로맨스,롯데컬처웍스(주)롯데엔터테인먼트,남자,남자,남자,0
1974,지금 만나러 갑니다,2018-03-14,2018-04-16,33,324,202,40295,7.5,22555500,20702258728,3022,2589462,0,멜로/로맨스,롯데컬처웍스(주)롯데엔터테인먼트,남자,남자,남자,0
1975,지금 만나러 갑니다,2018-03-14,2018-04-17,34,312,201,38785,6.4,18654900,20720913628,2496,2591958,0,멜로/로맨스,롯데컬처웍스(주)롯데엔터테인먼트,남자,남자,남자,0
1976,지금 만나러 갑니다,2018-03-14,2018-04-18,35,329,204,40321,6.4,19106300,20740019928,2559,2594517,0,멜로/로맨스,롯데컬처웍스(주)롯데엔터테인먼트,남자,남자,남자,0
1977,지금 만나러 갑니다,2018-03-14,2018-04-19,36,74,51,8892,8.3,5017300,20745037228,738,2595255,0,멜로/로맨스,롯데컬처웍스(주)롯데엔터테인먼트,남자,남자,남자,0
1978,지금 만나러 갑니다,2018-03-14,2018-04-20,37,76,55,9739,12.9,9398200,20754435428,1251,2596506,0,멜로/로맨스,롯데컬처웍스(주)롯데엔터테인먼트,남자,남자,남자,0
1979,지금 만나러 갑니다,2018-03-14,2018-04-21,38,73,48,8489,14.9,11187200,20765622628,1268,2597774,0,멜로/로맨스,롯데컬처웍스(주)롯데엔터테인먼트,남자,남자,남자,0
1980,지금 만나러 갑니다,2018-03-14,2018-04-22,39,74,49,8664,15.3,11482000,20777104628,1326,2599100,0,멜로/로맨스,롯데컬처웍스(주)롯데엔터테인먼트,남자,남자,남자,0
1981,지금 만나러 갑니다,2018-03-14,2018-04-23,40,82,57,9938,5.3,4092600,20781197228,527,2599627,0,멜로/로맨스,롯데컬처웍스(주)롯데엔터테인먼트,남자,남자,남자,0
1982,지금 만나러 갑니다,2018-03-14,2018-04-24,41,77,52,9627,6.6,4556900,20785754128,634,2600261,0,멜로/로맨스,롯데컬처웍스(주)롯데엔터테인먼트,남자,남자,남자,0
1983,지금 만나러 갑니다,2018-03-14,2018-04-25,42,2,2,305,7.2,124000,20785878128,22,2600283,0,멜로/로맨스,롯데컬처웍스(주)롯데엔터테인먼트,남자,남자,남자,0
1984,지금 만나러 갑니다,2018-03-14,2018-04-26,43,2,1,70,32.9,215000,20786093128,23,2600306,0,멜로/로맨스,롯데컬처웍스(주)롯데엔터테인먼트,남자,남자,남자,0
1985,지금 만나러 갑니다,2018-03-14,2018-04-27,44,2,1,70,55.7,362800,20786455928,39,2600345,0,멜로/로맨스,롯데컬처웍스(주)롯데엔터테인먼트,남자,남자,남자,0
1986,지금 만나러 갑니다,2018-03-14,2018-04-28,45,1,1,42,88.1,383500,20786839428,37,2600382,0,멜로/로맨스,롯데컬처웍스(주)롯데엔터테인먼트,남자,남자,남자,0
1987,지금 만나러 갑니다,2018-03-14,2018-04-29,46,1,1,35,100.0,327900,20787167328,35,2600417,0,멜로/로맨스,롯데컬처웍스(주)롯데엔터테인먼트,남자,남자,남자,0
1988,지금 만나러 갑니다,2018-03-14,2018-04-30,47,3,1,105,54.3,500800,20787668128,57,2600474,0,멜로/로맨스,롯데컬처웍스(주)롯데엔터테인먼트,남자,남자,남자,0
1989,지금 만나러 갑니다,2018-03-14,2018-05-01,48,2,1,70,75.7,475700,20788143828,53,2600527,0,멜로/로맨스,롯데컬처웍스(주)롯데엔터테인먼트,남자,남자,남자,0
1990,지금 만나러 갑니다,2018-03-14,2018-05-02,49,3,1,105,13.3,120300,20788264128,14,2600541,0,멜로/로맨스,롯데컬처웍스(주)롯데엔터테인먼트,남자,남자,남자,0
1991,지금 만나러 갑니다,2018-03-14,2018-05-03,50,3,1,105,26.7,224100,20788488228,28,2600569,0,멜로/로맨스,롯데컬처웍스(주)롯데엔터테인먼트,남자,남자,남자,0
1992,지금 만나러 갑니다,2018-03-14,2018-05-04,51,4,2,301,72.4,1798300,20790286528,218,2600787,0,멜로/로맨스,롯데컬처웍스(주)롯데엔터테인먼트,남자,남자,남자,0
1993,지금 만나러 갑니다,2018-03-14,2018-05-05,52,3,2,112,52.7,494500,20790781028,59,2600846,0,멜로/로맨스,롯데컬처웍스(주)롯데엔터테인먼트,남자,남자,남자,0
1994,지금 만나러 갑니다,2018-03-14,2018-05-06,53,3,2,112,34.8,382000,20791163028,39,2600885,0,멜로/로맨스,롯데컬처웍스(주)롯데엔터테인먼트,남자,남자,남자,0
1995,지금 만나러 갑니다,2018-03-14,2018-05-07,54,3,1,105,41.9,338000,20791501028,44,2600929,0,멜로/로맨스,롯데컬처웍스(주)롯데엔터테인먼트,남자,남자,남자,0
1996,지금 만나러 갑니다,2018-03-14,2018-05-08,55,2,1,70,12.9,72800,20791573828,9,2600938,0,멜로/로맨스,롯데컬처웍스(주)롯데엔터테인먼트,남자,남자,남자,0
1997,지금 만나러 갑니다,2018-03-14,2018-05-09,56,1,1,35,11.4,38000,20791611828,4,2600942,0,멜로/로맨스,롯데컬처웍스(주)롯데엔터테인먼트,남자,남자,남자,0
1998,지금 만나러 갑니다,2018-03-14,2018-05-10,57,2,1,70,15.7,90800,20791702628,11,2600953,0,멜로/로맨스,롯데컬처웍스(주)롯데엔터테인먼트,남자,남자,남자,0
1999,지금 만나러 갑니다,2018-03-14,2018-05-11,58,2,1,70,18.6,120800,20791823428,13,2600966,0,멜로/로맨스,롯데컬처웍스(주)롯데엔터테인먼트,남자,남자,남자,0
2000,지금 만나러 갑니다,2018-03-14,2018-05-12,59,3,3,147,24.5,338900,20792162328,36,2601002,0,멜로/로맨스,롯데컬처웍스(주)롯데엔터테인먼트,남자,남자,남자,0
2001,지금 만나러 갑니다,2018-03-14,2018-05-13,60,2,2,185,9.2,154300,20792316628,17,2601019,0,멜로/로맨스,롯데컬처웍스(주)롯데엔터테인먼트,남자,남자,남자,0
2002,지금 만나러 갑니다,2018-03-14,2018-05-14,61,2,1,70,11.4,67500,20792384128,8,2601027,0,멜로/로맨스,롯데컬처웍스(주)롯데엔터테인먼트,남자,남자,남자,0
2003,지금 만나러 갑니다,2018-03-14,2018-05-15,62,2,1,70,12.9,75000,20792459128,9,2601036,0,멜로/로맨스,롯데컬처웍스(주)롯데엔터테인먼트,남자,남자,남자,0
2004,지금 만나러 갑니다,2018-03-14,2018-05-16,63,3,2,494,0.0,0,20792459128,0,2601036,0,멜로/로맨스,롯데컬처웍스(주)롯데엔터테인먼트,남자,남자,남자,0
2005,지금 만나러 갑니다,2018-03-14,2018-05-19,66,2,2,77,22.1,156000,20792615128,17,2601053,0,멜로/로맨스,롯데컬처웍스(주)롯데엔터테인먼트,남자,남자,남자,0
2006,지금 만나러 갑니다,2018-03-14,2018-05-20,67,1,1,35,45.7,153000,20792768128,16,2601069,0,멜로/로맨스,롯데컬처웍스(주)롯데엔터테인먼트,남자,남자,남자,0
2007,지금 만나러 갑니다,2018-03-14,2018-05-21,68,1,1,35,28.6,100000,20792868128,10,2601079,0,멜로/로맨스,롯데컬처웍스(주)롯데엔터테인먼트,남자,남자,남자,0
2008,지금 만나러 갑니다,2018-03-14,2018-05-31,78,1,1,292,75.3,1320000,20794188128,220,2601299,0,멜로/로맨스,롯데컬처웍스(주)롯데엔터테인먼트,남자,남자,남자,0
2009,지금 만나러 갑니다,2018-03-14,2018-06-05,83,1,1,119,100.0,952000,20795140128,119,2601418,0,멜로/로맨스,롯데컬처웍스(주)롯데엔터테인먼트,남자,남자,남자,0
2010,지금 만나러 갑니다,2018-03-14,2018-06-06,84,1,1,27,100.0,297000,20795437128,27,2601445,0,멜로/로맨스,롯데컬처웍스(주)롯데엔터테인먼트,남자,남자,남자,0
2011,지금 만나러 갑니다,2018-03-14,2018-06-11,89,1,1,85,70.6,360000,20795797128,60,2601505,0,멜로/로맨스,롯데컬처웍스(주)롯데엔터테인먼트,남자,남자,남자,0
2012,지금 만나러 갑니다,2018-03-14,2018-06-14,92,1,1,24,100.0,120000,20795917128,24,2601529,0,멜로/로맨스,롯데컬처웍스(주)롯데엔터테인먼트,남자,남자,남자,0
2013,지금 만나러 갑니다,2018-03-14,2018-07-04,112,1,1,257,0.0,0,20795917128,0,2601529,0,멜로/로맨스,롯데컬처웍스(주)롯데엔터테인먼트,남자,남자,남자,0
2014,지금 만나러 갑니다,2018-03-14,2018-07-06,114,1,1,257,0.0,0,20795917128,0,2601529,0,멜로/로맨스,롯데컬처웍스(주)롯데엔터테인먼트,남자,남자,남자,0
2015,지금 만나러 갑니다,2018-03-14,2018-07-14,122,15,15,1701,9.9,1155000,20797072128,168,2601697,0,멜로/로맨스,롯데컬처웍스(주)롯데엔터테인먼트,남자,남자,남자,0
2016,지금 만나러 갑니다,2018-03-14,2018-07-15,123,16,15,2110,7.6,1108500,20798180628,160,2601857,0,멜로/로맨스,롯데컬처웍스(주)롯데엔터테인먼트,남자,남자,남자,0
2017,지금 만나러 갑니다,2018-03-14,2018-07-16,124,16,15,2040,4.2,572000,20798752628,86,2601943,0,멜로/로맨스,롯데컬처웍스(주)롯데엔터테인먼트,남자,남자,남자,0
2018,지금 만나러 갑니다,2018-03-14,2018-07-17,125,17,16,2106,3.1,443000,20799195628,66,2602009,0,멜로/로맨스,롯데컬처웍스(주)롯데엔터테인먼트,남자,남자,남자,0
2019,지금 만나러 갑니다,2018-03-14,2018-07-18,126,12,12,1433,2.8,273000,20799468628,40,2602049,0,멜로/로맨스,롯데컬처웍스(주)롯데엔터테인먼트,남자,남자,남자,0
2020,지금 만나러 갑니다,2018-03-14,2018-07-19,127,11,11,1278,4.9,428000,20799896628,63,2602112,0,멜로/로맨스,롯데컬처웍스(주)롯데엔터테인먼트,남자,남자,남자,0
2021,지금 만나러 갑니다,2018-03-14,2018-07-20,128,6,6,786,5.1,267000,20800163628,40,2602152,0,멜로/로맨스,롯데컬처웍스(주)롯데엔터테인먼트,남자,남자,남자,0
2022,지금 만나러 갑니다,2018-03-14,2018-07-21,129,5,5,691,2.9,134000,20800297628,20,2602172,0,멜로/로맨스,롯데컬처웍스(주)롯데엔터테인먼트,남자,남자,남자,0
2023,지금 만나러 갑니다,2018-03-14,2018-07-22,130,5,5,691,5.4,246500,20800544128,37,2602209,0,멜로/로맨스,롯데컬처웍스(주)롯데엔터테인먼트,남자,남자,남자,0
2024,지금 만나러 갑니다,2018-03-14,2018-07-23,131,2,2,327,2.5,52000,20800596128,8,2602217,0,멜로/로맨스,롯데컬처웍스(주)롯데엔터테인먼트,남자,남자,남자,0
2025,지금 만나러 갑니다,2018-03-14,2018-07-24,132,5,5,680,8.2,320000,20800916128,56,2602273,0,멜로/로맨스,롯데컬처웍스(주)롯데엔터테인먼트,남자,남자,남자,0
2026,곤지암,2018-03-28,2018-03-14,-14,5,5,1111,100.0,8925000,8925000,1111,1111,0,"공포(호러),스릴러",(주)쇼박스,남자,남자,남자,0
2027,곤지암,2018-03-28,2018-03-15,-13,4,4,907,100.0,7639000,16564000,907,2018,0,"공포(호러),스릴러",(주)쇼박스,남자,남자,남자,0
2028,곤지암,2018-03-28,2018-03-16,-12,15,15,2774,97.9,23770000,40334000,2716,4734,0,"공포(호러),스릴러",(주)쇼박스,남자,남자,남자,0
2029,곤지암,2018-03-28,2018-03-17,-11,10,10,1726,100.0,14964000,55298000,1726,6460,0,"공포(호러),스릴러",(주)쇼박스,남자,남자,남자,0
2030,곤지암,2018-03-28,2018-03-18,-10,1,1,153,65.4,900000,56198000,100,6560,0,"공포(호러),스릴러",(주)쇼박스,남자,남자,남자,0
2031,곤지암,2018-03-28,2018-03-19,-9,5,5,1368,98.4,11374000,67572000,1346,7906,0,"공포(호러),스릴러",(주)쇼박스,남자,남자,남자,0
2032,곤지암,2018-03-28,2018-03-20,-8,10,10,2267,99.7,19011000,86583000,2259,10165,0,"공포(호러),스릴러",(주)쇼박스,남자,남자,남자,0
2033,곤지암,2018-03-28,2018-03-21,-7,5,5,1178,100.0,8908000,95491000,1178,11343,0,"공포(호러),스릴러",(주)쇼박스,남자,남자,남자,0
2034,곤지암,2018-03-28,2018-03-22,-6,9,9,1806,100.0,14360000,109851000,1806,13149,0,"공포(호러),스릴러",(주)쇼박스,남자,남자,남자,0
2035,곤지암,2018-03-28,2018-03-23,-5,10,9,1599,89.9,10436000,120287000,1438,14587,0,"공포(호러),스릴러",(주)쇼박스,남자,남자,남자,0
2036,곤지암,2018-03-28,2018-03-24,-4,274,152,43890,55.4,186732500,307019500,24301,38888,0,"공포(호러),스릴러",(주)쇼박스,남자,남자,남자,0
2037,곤지암,2018-03-28,2018-03-25,-3,274,153,43593,66.6,224427800,531447300,29041,67929,0,"공포(호러),스릴러",(주)쇼박스,남자,남자,남자,0
2038,곤지암,2018-03-28,2018-03-26,-2,1,1,155,99.4,1078000,532525300,154,68083,0,"공포(호러),스릴러",(주)쇼박스,남자,남자,남자,0
2039,곤지암,2018-03-28,2018-03-28,0,3501,808,553558,35.8,1256715400,1789240700,198365,266448,0,"공포(호러),스릴러",(주)쇼박스,남자,남자,남자,0
2040,곤지암,2018-03-28,2018-03-29,1,3713,849,583903,20.2,912146400,2701387100,117945,384393,0,"공포(호러),스릴러",(주)쇼박스,남자,남자,남자,0
2041,곤지암,2018-03-28,2018-03-30,2,4237,954,671435,27.7,1545170863,4246557963,185811,570204,0,"공포(호러),스릴러",(주)쇼박스,남자,남자,남자,0
2042,곤지암,2018-03-28,2018-03-31,3,5360,1075,898565,47.1,3452613511,7699171474,423340,993544,0,"공포(호러),스릴러",(주)쇼박스,남자,남자,남자,0
2043,곤지암,2018-03-28,2018-04-01,4,5433,1124,911306,41.0,3047696300,10746867774,373836,1367380,0,"공포(호러),스릴러",(주)쇼박스,남자,남자,남자,0
2044,곤지암,2018-03-28,2018-04-02,5,4797,927,830053,13.2,844662000,11591529774,109505,1476885,0,"공포(호러),스릴러",(주)쇼박스,남자,남자,남자,0
2045,곤지암,2018-03-28,2018-04-03,6,4820,977,826961,10.6,673013300,12264543074,87577,1564462,0,"공포(호러),스릴러",(주)쇼박스,남자,남자,남자,0
2046,곤지암,2018-03-28,2018-04-04,7,5240,989,929262,9.9,701735100,12966278174,92046,1656508,0,"공포(호러),스릴러",(주)쇼박스,남자,남자,남자,0
2047,곤지암,2018-03-28,2018-04-05,8,4758,896,856902,9.1,600953900,13567232074,78273,1734781,0,"공포(호러),스릴러",(주)쇼박스,남자,남자,남자,0
2048,곤지암,2018-03-28,2018-04-06,9,4875,922,881142,12.6,940223570,14507455644,111319,1846100,0,"공포(호러),스릴러",(주)쇼박스,남자,남자,남자,0
2049,곤지암,2018-03-28,2018-04-07,10,5177,950,924524,24.5,1889606964,16397062608,226594,2072694,0,"공포(호러),스릴러",(주)쇼박스,남자,남자,남자,0
2050,곤지암,2018-03-28,2018-04-08,11,4949,947,883887,19.9,1478341600,17875404208,175711,2248405,0,"공포(호러),스릴러",(주)쇼박스,남자,남자,남자,0
2051,곤지암,2018-03-28,2018-04-09,12,4288,843,744188,6.3,362343100,18237747308,47017,2295422,0,"공포(호러),스릴러",(주)쇼박스,남자,남자,남자,0
2052,곤지암,2018-03-28,2018-04-10,13,4198,845,729000,5.6,312640700,18550388008,40526,2335948,0,"공포(호러),스릴러",(주)쇼박스,남자,남자,남자,0
2053,곤지암,2018-03-28,2018-04-11,14,4045,844,695256,5.9,322855400,18873243408,40888,2376836,0,"공포(호러),스릴러",(주)쇼박스,남자,남자,남자,0
2054,곤지암,2018-03-28,2018-04-12,15,1994,543,304815,8.0,196047600,19069291008,24288,2401124,0,"공포(호러),스릴러",(주)쇼박스,남자,남자,남자,0
2055,곤지암,2018-03-28,2018-04-13,16,2096,552,322281,11.5,322938213,19392229221,37043,2438167,0,"공포(호러),스릴러",(주)쇼박스,남자,남자,남자,0
2056,곤지암,2018-03-28,2018-04-14,17,2101,608,312204,24.4,664276623,20056505844,76299,2514466,0,"공포(호러),스릴러",(주)쇼박스,남자,남자,남자,0
2057,곤지암,2018-03-28,2018-04-15,18,1969,586,292169,18.1,462040800,20518546644,52792,2567258,0,"공포(호러),스릴러",(주)쇼박스,남자,남자,남자,0
2058,곤지암,2018-03-28,2018-04-16,19,1681,498,244973,5.5,109182800,20627729444,13543,2580801,0,"공포(호러),스릴러",(주)쇼박스,남자,남자,남자,0
2059,곤지암,2018-03-28,2018-04-17,20,1609,491,233887,5.1,95961900,20723691344,11893,2592694,0,"공포(호러),스릴러",(주)쇼박스,남자,남자,남자,0
2060,곤지암,2018-03-28,2018-04-18,21,1605,499,232463,5.0,92532400,20816223744,11576,2604270,0,"공포(호러),스릴러",(주)쇼박스,남자,남자,남자,0
2061,곤지암,2018-03-28,2018-04-19,22,862,374,117128,7.2,69530800,20885754544,8387,2612657,0,"공포(호러),스릴러",(주)쇼박스,남자,남자,남자,0
2062,곤지암,2018-03-28,2018-04-20,23,908,392,122483,8.8,96549600,20982304144,10770,2623427,0,"공포(호러),스릴러",(주)쇼박스,남자,남자,남자,0
2063,곤지암,2018-03-28,2018-04-21,24,961,427,127566,17.0,193444900,21175749044,21697,2645124,0,"공포(호러),스릴러",(주)쇼박스,남자,남자,남자,0
2064,곤지암,2018-03-28,2018-04-22,25,928,416,122466,14.1,156469000,21332218044,17253,2662377,0,"공포(호러),스릴러",(주)쇼박스,남자,남자,남자,0
2065,곤지암,2018-03-28,2018-04-23,26,781,361,102351,5.1,42851900,21375069944,5227,2667604,0,"공포(호러),스릴러",(주)쇼박스,남자,남자,남자,0
2066,곤지암,2018-03-28,2018-04-24,27,720,347,94504,4.9,38293600,21413363544,4645,2672249,0,"공포(호러),스릴러",(주)쇼박스,남자,남자,남자,0
2067,곤지암,2018-03-28,2018-04-25,28,27,25,3352,6.7,1641100,21415004644,225,2672474,0,"공포(호러),스릴러",(주)쇼박스,남자,남자,남자,0
2068,곤지암,2018-03-28,2018-04-26,29,25,21,2955,9.6,2370700,21417375344,284,2672758,0,"공포(호러),스릴러",(주)쇼박스,남자,남자,남자,0
2069,곤지암,2018-03-28,2018-04-27,30,29,24,3416,16.4,4710600,21422085944,559,2673317,0,"공포(호러),스릴러",(주)쇼박스,남자,남자,남자,0
2070,곤지암,2018-03-28,2018-04-28,31,24,17,2489,17.5,3956300,21426042244,435,2673752,0,"공포(호러),스릴러",(주)쇼박스,남자,남자,남자,0
2071,곤지암,2018-03-28,2018-04-29,32,20,13,2164,18.8,3610600,21429652844,406,2674158,0,"공포(호러),스릴러",(주)쇼박스,남자,남자,남자,0
2072,곤지암,2018-03-28,2018-04-30,33,25,16,2776,12.0,2834700,21432487544,334,2674492,0,"공포(호러),스릴러",(주)쇼박스,남자,남자,남자,0
2073,곤지암,2018-03-28,2018-05-01,34,13,7,1375,21.2,2474100,21434961644,291,2674783,0,"공포(호러),스릴러",(주)쇼박스,남자,남자,남자,0
2074,곤지암,2018-03-28,2018-05-02,35,12,8,1262,6.7,750600,21435712244,85,2674868,0,"공포(호러),스릴러",(주)쇼박스,남자,남자,남자,0
2075,곤지암,2018-03-28,2018-05-03,36,4,4,392,8.9,245500,21435957744,35,2674903,0,"공포(호러),스릴러",(주)쇼박스,남자,남자,남자,0
2076,곤지암,2018-03-28,2018-05-04,37,6,5,467,9.0,388500,21436346244,42,2674945,0,"공포(호러),스릴러",(주)쇼박스,남자,남자,남자,0
2077,곤지암,2018-03-28,2018-05-05,38,8,7,794,20.8,1529300,21437875544,165,2675110,0,"공포(호러),스릴러",(주)쇼박스,남자,남자,남자,0
2078,곤지암,2018-03-28,2018-05-06,39,9,8,788,27.2,2005300,21439880844,214,2675324,0,"공포(호러),스릴러",(주)쇼박스,남자,남자,남자,0
2079,곤지암,2018-03-28,2018-05-07,40,7,6,478,18.0,854500,21440735344,86,2675410,0,"공포(호러),스릴러",(주)쇼박스,남자,남자,남자,0
2080,곤지암,2018-03-28,2018-05-08,41,8,5,486,7.4,303800,21441039144,36,2675446,0,"공포(호러),스릴러",(주)쇼박스,남자,남자,남자,0
2081,곤지암,2018-03-28,2018-05-09,42,3,2,154,4.6,70000,21441109144,7,2675453,0,"공포(호러),스릴러",(주)쇼박스,남자,남자,남자,0
2082,곤지암,2018-03-28,2018-05-10,43,2,1,118,7.6,90000,21441199144,9,2675462,0,"공포(호러),스릴러",(주)쇼박스,남자,남자,남자,0
2083,곤지암,2018-03-28,2018-05-11,44,1,1,59,11.9,70000,21441269144,7,2675469,0,"공포(호러),스릴러",(주)쇼박스,남자,남자,남자,0
2084,곤지암,2018-03-28,2018-05-12,45,2,1,118,17.0,198000,21441467144,20,2675489,0,"공포(호러),스릴러",(주)쇼박스,남자,남자,남자,0
2085,곤지암,2018-03-28,2018-05-13,46,2,1,118,17.8,206000,21441673144,21,2675510,0,"공포(호러),스릴러",(주)쇼박스,남자,남자,남자,0
2086,곤지암,2018-03-28,2018-05-14,47,1,1,97,3.1,28000,21441701144,3,2675513,0,"공포(호러),스릴러",(주)쇼박스,남자,남자,남자,0
2087,곤지암,2018-03-28,2018-05-15,48,2,1,194,6.7,83000,21441784144,13,2675526,0,"공포(호러),스릴러",(주)쇼박스,남자,남자,남자,0
2088,곤지암,2018-03-28,2018-05-16,49,1,1,59,3.4,20000,21441804144,2,2675528,0,"공포(호러),스릴러",(주)쇼박스,남자,남자,남자,0
2089,곤지암,2018-03-28,2018-05-17,50,1,1,59,1.7,10000,21441814144,1,2675529,0,"공포(호러),스릴러",(주)쇼박스,남자,남자,남자,0
2090,곤지암,2018-03-28,2018-05-19,52,1,1,59,18.6,110000,21441924144,11,2675540,0,"공포(호러),스릴러",(주)쇼박스,남자,남자,남자,0
2091,곤지암,2018-03-28,2018-05-20,53,1,1,59,6.8,40000,21441964144,4,2675544,0,"공포(호러),스릴러",(주)쇼박스,남자,남자,남자,0
2092,곤지암,2018-03-28,2018-05-22,55,1,1,59,3.4,20000,21441984144,2,2675546,0,"공포(호러),스릴러",(주)쇼박스,남자,남자,남자,0
2093,곤지암,2018-03-28,2018-05-25,58,1,1,59,3.4,20000,21442004144,2,2675548,0,"공포(호러),스릴러",(주)쇼박스,남자,남자,남자,0
2094,곤지암,2018-03-28,2018-05-26,59,1,1,59,10.2,60000,21442064144,6,2675554,0,"공포(호러),스릴러",(주)쇼박스,남자,남자,남자,0
2095,곤지암,2018-03-28,2018-05-27,60,1,1,59,6.8,40000,21442104144,4,2675558,0,"공포(호러),스릴러",(주)쇼박스,남자,남자,남자,0
2096,곤지암,2018-03-28,2018-05-30,63,1,1,59,1.7,10000,21442114144,1,2675559,0,"공포(호러),스릴러",(주)쇼박스,남자,남자,남자,0
2097,곤지암,2018-03-28,2018-07-05,99,1,1,72,0.0,0,21442114144,0,2675559,0,"공포(호러),스릴러",(주)쇼박스,남자,남자,남자,0
2098,곤지암,2018-03-28,2018-08-30,155,1,1,278,0.4,5000,21442119144,1,2675560,0,"공포(호러),스릴러",(주)쇼박스,남자,남자,남자,0
2099,곤지암,2018-03-28,2018-09-01,157,1,1,114,1.8,10000,21442129144,2,2675562,0,"공포(호러),스릴러",(주)쇼박스,남자,남자,남자,0
2100,곤지암,2018-03-28,2018-09-02,158,1,1,114,1.8,10000,21442139144,2,2675564,0,"공포(호러),스릴러",(주)쇼박스,남자,남자,남자,0
2101,곤지암,2018-03-28,2018-09-03,159,1,1,278,1.8,25000,21442164144,5,2675569,0,"공포(호러),스릴러",(주)쇼박스,남자,남자,남자,0
2102,곤지암,2018-03-28,2018-09-05,161,1,1,114,0.9,5000,21442169144,1,2675570,0,"공포(호러),스릴러",(주)쇼박스,남자,남자,남자,0
2103,곤지암,2018-03-28,2018-09-07,163,1,1,114,1.8,10000,21442179144,2,2675572,0,"공포(호러),스릴러",(주)쇼박스,남자,남자,남자,0
2104,곤지암,2018-03-28,2018-09-08,164,1,1,114,2.6,15000,21442194144,3,2675575,0,"공포(호러),스릴러",(주)쇼박스,남자,남자,남자,0
2105,곤지암,2018-03-28,2018-11-16,233,1,1,85,0.0,0,21442194144,0,2675575,0,"공포(호러),스릴러",(주)쇼박스,남자,남자,남자,0
2106,곤지암,2018-03-28,2019-04-12,380,11,11,2019,2.8,374000,21442568144,56,2675631,0,"공포(호러),스릴러",(주)쇼박스,남자,남자,남자,0
2107,곤지암,2018-03-28,2019-04-13,381,9,9,1664,2.5,277500,21442845644,42,2675673,0,"공포(호러),스릴러",(주)쇼박스,남자,남자,남자,0
2108,곤지암,2018-03-28,2019-04-14,382,6,6,984,2.7,178500,21443024144,27,2675700,0,"공포(호러),스릴러",(주)쇼박스,남자,남자,남자,0
2109,곤지암,2018-03-28,2019-04-15,383,7,7,1291,1.9,168000,21443192144,25,2675725,0,"공포(호러),스릴러",(주)쇼박스,남자,남자,남자,0
2110,곤지암,2018-03-28,2019-04-16,384,6,6,1043,1.2,84000,21443276144,12,2675737,0,"공포(호러),스릴러",(주)쇼박스,남자,남자,남자,0
2111,곤지암,2018-03-28,2019-04-17,385,7,7,1262,1.3,100000,21443376144,16,2675753,0,"공포(호러),스릴러",(주)쇼박스,남자,남자,남자,0
2112,곤지암,2018-03-28,2019-04-18,386,9,9,1667,2.0,218500,21443594644,34,2675787,0,"공포(호러),스릴러",(주)쇼박스,남자,남자,남자,0
2113,곤지암,2018-03-28,2019-04-19,387,7,7,1305,2.9,252000,21443846644,38,2675825,0,"공포(호러),스릴러",(주)쇼박스,남자,남자,남자,0
2114,곤지암,2018-03-28,2019-04-20,388,8,8,1418,2.8,259000,21444105644,39,2675864,0,"공포(호러),스릴러",(주)쇼박스,남자,남자,남자,0
2115,곤지암,2018-03-28,2019-04-21,389,6,6,1222,1.6,130500,21444236144,19,2675883,0,"공포(호러),스릴러",(주)쇼박스,남자,남자,남자,0
2116,바람 바람 바람,2018-04-05,2018-03-22,-14,4,3,1279,82.9,9530000,9530000,1060,1060,0,코미디,(주)넥스트엔터테인먼트월드(NEW),남자,남자,남자,0
2117,바람 바람 바람,2018-04-05,2018-03-23,-13,1,1,117,0.0,0,9530000,0,1060,0,코미디,(주)넥스트엔터테인먼트월드(NEW),남자,남자,남자,0
2118,바람 바람 바람,2018-04-05,2018-03-27,-9,12,12,3508,98.2,28079000,37609000,3446,4506,0,코미디,(주)넥스트엔터테인먼트월드(NEW),남자,남자,남자,0
2119,바람 바람 바람,2018-04-05,2018-03-28,-8,13,9,2081,99.7,18097000,55706000,2075,6581,0,코미디,(주)넥스트엔터테인먼트월드(NEW),남자,남자,남자,0
2120,바람 바람 바람,2018-04-05,2018-03-29,-7,6,6,1274,100.9,6952000,62658000,1286,7867,0,코미디,(주)넥스트엔터테인먼트월드(NEW),남자,남자,남자,0
2121,바람 바람 바람,2018-04-05,2018-03-31,-5,12,11,3115,77.1,19520700,82178700,2403,10270,0,코미디,(주)넥스트엔터테인먼트월드(NEW),남자,남자,남자,0
2122,바람 바람 바람,2018-04-05,2018-04-01,-4,9,9,1929,71.4,12306500,94485200,1377,11647,0,코미디,(주)넥스트엔터테인먼트월드(NEW),남자,남자,남자,0
2123,바람 바람 바람,2018-04-05,2018-04-02,-3,5,5,1002,99.4,8964000,103449200,996,12643,0,코미디,(주)넥스트엔터테인먼트월드(NEW),남자,남자,남자,0
2124,바람 바람 바람,2018-04-05,2018-04-03,-2,38,38,6246,76.6,35442000,138891200,4785,17428,0,코미디,(주)넥스트엔터테인먼트월드(NEW),남자,남자,남자,0
2125,바람 바람 바람,2018-04-05,2018-04-04,-1,1,1,313,0.6,18000,138909200,2,17430,0,코미디,(주)넥스트엔터테인먼트월드(NEW),남자,남자,남자,0
2126,바람 바람 바람,2018-04-05,2018-04-05,0,3677,792,580007,16.5,712977000,851886200,95534,112964,0,코미디,(주)넥스트엔터테인먼트월드(NEW),남자,남자,남자,0
2127,바람 바람 바람,2018-04-05,2018-04-06,1,4105,955,644165,21.1,1036065712,1887951912,135974,248938,0,코미디,(주)넥스트엔터테인먼트월드(NEW),남자,남자,남자,0
2128,바람 바람 바람,2018-04-05,2018-04-07,2,4843,985,804165,25.7,1757492229,3645444141,206378,455316,0,코미디,(주)넥스트엔터테인먼트월드(NEW),남자,남자,남자,0
2129,바람 바람 바람,2018-04-05,2018-04-08,3,4658,968,777426,20.8,1382875900,5028320041,161658,616974,0,코미디,(주)넥스트엔터테인먼트월드(NEW),남자,남자,남자,0
2130,바람 바람 바람,2018-04-05,2018-04-09,4,4320,881,742198,7.7,429372800,5457692841,56883,673857,0,코미디,(주)넥스트엔터테인먼트월드(NEW),남자,남자,남자,0
2131,바람 바람 바람,2018-04-05,2018-04-10,5,4329,884,744550,7.4,415622900,5873315741,54858,728715,0,코미디,(주)넥스트엔터테인먼트월드(NEW),남자,남자,남자,0
2132,바람 바람 바람,2018-04-05,2018-04-11,6,4255,876,725209,8.1,456117500,6329433241,58994,787709,0,코미디,(주)넥스트엔터테인먼트월드(NEW),남자,남자,남자,0
2133,바람 바람 바람,2018-04-05,2018-04-12,7,2592,584,435180,8.3,280290900,6609724141,36074,823783,0,코미디,(주)넥스트엔터테인먼트월드(NEW),남자,남자,남자,0
2134,바람 바람 바람,2018-04-05,2018-04-13,8,2650,608,445706,9.4,364532712,6974256853,42063,865846,0,코미디,(주)넥스트엔터테인먼트월드(NEW),남자,남자,남자,0
2135,바람 바람 바람,2018-04-05,2018-04-14,9,2620,623,426277,20.2,763666830,7737923683,86145,951991,0,코미디,(주)넥스트엔터테인먼트월드(NEW),남자,남자,남자,0
2136,바람 바람 바람,2018-04-05,2018-04-15,10,2503,619,409400,14.1,515724000,8253647683,57646,1009637,0,코미디,(주)넥스트엔터테인먼트월드(NEW),남자,남자,남자,0
2137,바람 바람 바람,2018-04-05,2018-04-16,11,2438,550,388680,5.8,176245600,8429893283,22433,1032070,0,코미디,(주)넥스트엔터테인먼트월드(NEW),남자,남자,남자,0
2138,바람 바람 바람,2018-04-05,2018-04-17,12,2386,561,381381,5.7,169063600,8598956883,21724,1053794,0,코미디,(주)넥스트엔터테인먼트월드(NEW),남자,남자,남자,0
2139,바람 바람 바람,2018-04-05,2018-04-18,13,2351,562,373716,5.5,161380200,8760337083,20656,1074450,0,코미디,(주)넥스트엔터테인먼트월드(NEW),남자,남자,남자,0
2140,바람 바람 바람,2018-04-05,2018-04-19,14,1481,456,218562,6.3,110122600,8870459683,13827,1088277,0,코미디,(주)넥스트엔터테인먼트월드(NEW),남자,남자,남자,0
2141,바람 바람 바람,2018-04-05,2018-04-20,15,1553,483,228192,7.5,151801099,9022260782,17175,1105452,0,코미디,(주)넥스트엔터테인먼트월드(NEW),남자,남자,남자,0
2142,바람 바람 바람,2018-04-05,2018-04-21,16,1583,489,236943,11.2,240752993,9263013775,26596,1132048,0,코미디,(주)넥스트엔터테인먼트월드(NEW),남자,남자,남자,0
2143,바람 바람 바람,2018-04-05,2018-04-22,17,1557,492,234316,11.7,249210000,9512223775,27399,1159447,0,코미디,(주)넥스트엔터테인먼트월드(NEW),남자,남자,남자,0
2144,바람 바람 바람,2018-04-05,2018-04-23,18,1544,474,230272,5.9,108671000,9620894775,13678,1173125,0,코미디,(주)넥스트엔터테인먼트월드(NEW),남자,남자,남자,0
2145,바람 바람 바람,2018-04-05,2018-04-24,19,1516,479,226610,5.2,93297500,9714192275,11832,1184957,0,코미디,(주)넥스트엔터테인먼트월드(NEW),남자,남자,남자,0
2146,바람 바람 바람,2018-04-05,2018-04-25,20,138,94,16976,11.9,12713400,9726905675,2023,1186980,0,코미디,(주)넥스트엔터테인먼트월드(NEW),남자,남자,남자,0
2147,바람 바람 바람,2018-04-05,2018-04-26,21,125,79,15290,8.9,10313500,9737219175,1354,1188334,0,코미디,(주)넥스트엔터테인먼트월드(NEW),남자,남자,남자,0
2148,바람 바람 바람,2018-04-05,2018-04-27,22,125,78,14930,7.8,9743600,9746962775,1158,1189492,0,코미디,(주)넥스트엔터테인먼트월드(NEW),남자,남자,남자,0
2149,바람 바람 바람,2018-04-05,2018-04-28,23,88,57,11200,11.5,10375400,9757338175,1288,1190780,0,코미디,(주)넥스트엔터테인먼트월드(NEW),남자,남자,남자,0
2150,바람 바람 바람,2018-04-05,2018-04-29,24,86,54,10630,9.4,8434200,9765772375,996,1191776,0,코미디,(주)넥스트엔터테인먼트월드(NEW),남자,남자,남자,0
2151,바람 바람 바람,2018-04-05,2018-04-30,25,116,64,13820,8.2,8525200,9774297575,1131,1192907,0,코미디,(주)넥스트엔터테인먼트월드(NEW),남자,남자,남자,0
2152,바람 바람 바람,2018-04-05,2018-05-01,26,26,19,2868,18.0,4061500,9778359075,515,1193422,0,코미디,(주)넥스트엔터테인먼트월드(NEW),남자,남자,남자,0
2153,바람 바람 바람,2018-04-05,2018-05-02,27,30,22,3747,8.6,2385200,9780744275,321,1193743,0,코미디,(주)넥스트엔터테인먼트월드(NEW),남자,남자,남자,0
2154,바람 바람 바람,2018-04-05,2018-05-03,28,17,14,2030,7.2,956800,9781701075,146,1193889,0,코미디,(주)넥스트엔터테인먼트월드(NEW),남자,남자,남자,0
2155,바람 바람 바람,2018-04-05,2018-05-04,29,12,11,1474,3.4,390300,9782091375,50,1193939,0,코미디,(주)넥스트엔터테인먼트월드(NEW),남자,남자,남자,0
2156,바람 바람 바람,2018-04-05,2018-05-05,30,6,6,831,1.2,80500,9782171875,10,1193949,0,코미디,(주)넥스트엔터테인먼트월드(NEW),남자,남자,남자,0
2157,바람 바람 바람,2018-04-05,2018-05-06,31,6,6,793,2.9,186000,9782357875,23,1193972,0,코미디,(주)넥스트엔터테인먼트월드(NEW),남자,남자,남자,0
2158,바람 바람 바람,2018-04-05,2018-05-07,32,6,6,763,3.5,218000,9782575875,27,1193999,0,코미디,(주)넥스트엔터테인먼트월드(NEW),남자,남자,남자,0
2159,바람 바람 바람,2018-04-05,2018-05-08,33,11,9,1260,3.6,366000,9782941875,45,1194044,0,코미디,(주)넥스트엔터테인먼트월드(NEW),남자,남자,남자,0
2160,바람 바람 바람,2018-04-05,2018-05-09,34,4,4,540,1.7,55000,9782996875,9,1194053,0,코미디,(주)넥스트엔터테인먼트월드(NEW),남자,남자,남자,0
2161,바람 바람 바람,2018-04-05,2018-05-10,35,4,4,535,0.8,24000,9783020875,4,1194057,0,코미디,(주)넥스트엔터테인먼트월드(NEW),남자,남자,남자,0
2162,바람 바람 바람,2018-04-05,2018-05-11,36,8,5,1115,1.7,168000,9783188875,19,1194076,0,코미디,(주)넥스트엔터테인먼트월드(NEW),남자,남자,남자,0
2163,바람 바람 바람,2018-04-05,2018-05-12,37,8,5,1115,4.4,396000,9783584875,49,1194125,0,코미디,(주)넥스트엔터테인먼트월드(NEW),남자,남자,남자,0
2164,바람 바람 바람,2018-04-05,2018-05-13,38,9,6,1219,2.6,306000,9783890875,32,1194157,0,코미디,(주)넥스트엔터테인먼트월드(NEW),남자,남자,남자,0
2165,바람 바람 바람,2018-04-05,2018-05-14,39,9,6,1147,1.4,125000,9784015875,16,1194173,0,코미디,(주)넥스트엔터테인먼트월드(NEW),남자,남자,남자,0
2166,바람 바람 바람,2018-04-05,2018-05-15,40,7,4,935,2.4,165500,9784181375,22,1194195,0,코미디,(주)넥스트엔터테인먼트월드(NEW),남자,남자,남자,0
2167,바람 바람 바람,2018-04-05,2018-05-16,41,3,3,418,0.7,18000,9784199375,3,1194198,0,코미디,(주)넥스트엔터테인먼트월드(NEW),남자,남자,남자,0
2168,바람 바람 바람,2018-04-05,2018-05-17,42,2,2,344,0.6,12000,9784211375,2,1194200,0,코미디,(주)넥스트엔터테인먼트월드(NEW),남자,남자,남자,0
2169,바람 바람 바람,2018-04-05,2018-05-18,43,2,2,344,0.6,12000,9784223375,2,1194202,0,코미디,(주)넥스트엔터테인먼트월드(NEW),남자,남자,남자,0
2170,바람 바람 바람,2018-04-05,2018-05-19,44,2,2,344,0.6,12000,9784235375,2,1194204,0,코미디,(주)넥스트엔터테인먼트월드(NEW),남자,남자,남자,0
2171,바람 바람 바람,2018-04-05,2018-05-20,45,2,2,344,0.6,12000,9784247375,2,1194206,0,코미디,(주)넥스트엔터테인먼트월드(NEW),남자,남자,남자,0
2172,바람 바람 바람,2018-04-05,2018-05-21,46,2,2,308,0.7,12000,9784259375,2,1194208,0,코미디,(주)넥스트엔터테인먼트월드(NEW),남자,남자,남자,0
2173,바람 바람 바람,2018-04-05,2018-05-22,47,2,2,308,0.7,12000,9784271375,2,1194210,0,코미디,(주)넥스트엔터테인먼트월드(NEW),남자,남자,남자,0
2174,바람 바람 바람,2018-04-05,2018-05-23,48,2,2,289,0.7,12000,9784283375,2,1194212,0,코미디,(주)넥스트엔터테인먼트월드(NEW),남자,남자,남자,0
2175,바람 바람 바람,2018-04-05,2018-05-24,49,2,2,308,0.7,12000,9784295375,2,1194214,0,코미디,(주)넥스트엔터테인먼트월드(NEW),남자,남자,남자,0
2176,바람 바람 바람,2018-04-05,2018-05-25,50,2,2,308,0.7,12000,9784307375,2,1194216,0,코미디,(주)넥스트엔터테인먼트월드(NEW),남자,남자,남자,0
2177,바람 바람 바람,2018-04-05,2018-05-26,51,2,2,357,0.6,12000,9784319375,2,1194218,0,코미디,(주)넥스트엔터테인먼트월드(NEW),남자,남자,남자,0
2178,바람 바람 바람,2018-04-05,2018-05-27,52,2,2,357,0.6,12000,9784331375,2,1194220,0,코미디,(주)넥스트엔터테인먼트월드(NEW),남자,남자,남자,0
2179,바람 바람 바람,2018-04-05,2018-05-28,53,1,1,213,0.5,6000,9784337375,1,1194221,0,코미디,(주)넥스트엔터테인먼트월드(NEW),남자,남자,남자,0
2180,바람 바람 바람,2018-04-05,2018-06-06,62,1,1,213,0.5,6000,9784343375,1,1194222,0,코미디,(주)넥스트엔터테인먼트월드(NEW),남자,남자,남자,0
2181,바람 바람 바람,2018-04-05,2018-06-07,63,1,1,213,0.5,6000,9784349375,1,1194223,0,코미디,(주)넥스트엔터테인먼트월드(NEW),남자,남자,남자,0
2182,바람 바람 바람,2018-04-05,2018-06-08,64,1,1,213,0.5,6000,9784355375,1,1194224,0,코미디,(주)넥스트엔터테인먼트월드(NEW),남자,남자,남자,0
2183,바람 바람 바람,2018-04-05,2018-06-09,65,1,1,213,0.5,6000,9784361375,1,1194225,0,코미디,(주)넥스트엔터테인먼트월드(NEW),남자,남자,남자,0
2184,바람 바람 바람,2018-04-05,2018-06-10,66,1,1,213,0.5,6000,9784367375,1,1194226,0,코미디,(주)넥스트엔터테인먼트월드(NEW),남자,남자,남자,0
2185,바람 바람 바람,2018-04-05,2018-06-11,67,1,1,213,0.5,6000,9784373375,1,1194227,0,코미디,(주)넥스트엔터테인먼트월드(NEW),남자,남자,남자,0
2186,바람 바람 바람,2018-04-05,2018-06-12,68,1,1,213,0.5,6000,9784379375,1,1194228,0,코미디,(주)넥스트엔터테인먼트월드(NEW),남자,남자,남자,0
2187,바람 바람 바람,2018-04-05,2018-06-13,69,1,1,213,0.5,6000,9784385375,1,1194229,0,코미디,(주)넥스트엔터테인먼트월드(NEW),남자,남자,남자,0
2188,바람 바람 바람,2018-04-05,2018-07-04,90,1,1,72,0.0,0,9784385375,0,1194229,0,코미디,(주)넥스트엔터테인먼트월드(NEW),남자,남자,남자,0
2189,바람 바람 바람,2018-04-05,2018-07-06,92,1,1,72,0.0,0,9784385375,0,1194229,0,코미디,(주)넥스트엔터테인먼트월드(NEW),남자,남자,남자,0
2190,마녀,2018-06-27,2018-06-15,-12,3,1,996,83.3,3320000,3320000,830,830,1,"미스터리,액션",워너브러더스 코리아(주),남자,남자,여자,1
2191,마녀,2018-06-27,2018-06-19,-8,7,5,1897,82.8,14139000,17459000,1571,2401,1,"미스터리,액션",워너브러더스 코리아(주),남자,남자,여자,1
2192,마녀,2018-06-27,2018-06-20,-7,10,10,3036,99.2,27108000,44567000,3012,5413,1,"미스터리,액션",워너브러더스 코리아(주),남자,남자,여자,1
2193,마녀,2018-06-27,2018-06-23,-4,7,7,1391,55.0,8374900,52941900,765,6178,1,"미스터리,액션",워너브러더스 코리아(주),남자,남자,여자,1
2194,마녀,2018-06-27,2018-06-24,-3,1,1,180,100.0,2160000,55101900,180,6358,1,"미스터리,액션",워너브러더스 코리아(주),남자,남자,여자,1
2195,마녀,2018-06-27,2018-06-25,-2,4,4,1502,98.4,13302000,68403900,1478,7836,1,"미스터리,액션",워너브러더스 코리아(주),남자,남자,여자,1
2196,마녀,2018-06-27,2018-06-27,0,3793,880,680364,17.9,738666200,807070100,121990,129826,1,"미스터리,액션",워너브러더스 코리아(주),남자,남자,여자,1
2197,마녀,2018-06-27,2018-06-28,1,3980,864,721771,13.1,770347800,1577417900,94414,224240,1,"미스터리,액션",워너브러더스 코리아(주),남자,남자,여자,1
2198,마녀,2018-06-27,2018-06-29,2,4213,921,759372,17.9,1226299921,2803717821,136113,360353,1,"미스터리,액션",워너브러더스 코리아(주),남자,남자,여자,1
2199,마녀,2018-06-27,2018-06-30,3,4828,1054,872958,34.6,2743779931,5547497752,301612,661965,1,"미스터리,액션",워너브러더스 코리아(주),남자,남자,여자,1
2200,마녀,2018-06-27,2018-07-01,4,4880,1117,882737,33.6,2703207100,8250704852,296821,958786,1,"미스터리,액션",워너브러더스 코리아(주),남자,남자,여자,1
2201,마녀,2018-06-27,2018-07-02,5,4686,1017,858713,14.5,1018969200,9269674052,124470,1083256,1,"미스터리,액션",워너브러더스 코리아(주),남자,남자,여자,1
2202,마녀,2018-06-27,2018-07-03,6,4692,1033,864655,13.4,943439600,10213113652,115689,1198945,1,"미스터리,액션",워너브러더스 코리아(주),남자,남자,여자,1
2203,마녀,2018-06-27,2018-07-04,7,2374,667,319812,22.9,598075800,10811189452,73312,1272257,1,"미스터리,액션",워너브러더스 코리아(주),남자,남자,여자,1
2204,마녀,2018-06-27,2018-07-05,8,2530,694,341312,21.5,597387200,11408576652,73342,1345599,1,"미스터리,액션",워너브러더스 코리아(주),남자,남자,여자,1
2205,마녀,2018-06-27,2018-07-06,9,2762,729,365895,27.0,872389203,12280965855,98836,1444435,1,"미스터리,액션",워너브러더스 코리아(주),남자,남자,여자,1
2206,마녀,2018-06-27,2018-07-07,10,3079,801,416340,43.6,1617914916,13898880771,181475,1625910,1,"미스터리,액션",워너브러더스 코리아(주),남자,남자,여자,1
2207,마녀,2018-06-27,2018-07-08,11,3059,808,414433,41.2,1530371500,15429252271,170792,1796702,1,"미스터리,액션",워너브러더스 코리아(주),남자,남자,여자,1
2208,마녀,2018-06-27,2018-07-09,12,3112,750,429005,18.2,637982800,16067235071,77886,1874588,1,"미스터리,액션",워너브러더스 코리아(주),남자,남자,여자,1
2209,마녀,2018-06-27,2018-07-10,13,3155,772,437436,19.2,676843700,16744078771,83912,1958500,1,"미스터리,액션",워너브러더스 코리아(주),남자,남자,여자,1
2210,마녀,2018-06-27,2018-07-11,14,2713,662,361697,19.4,566881700,17310960471,70060,2028560,1,"미스터리,액션",워너브러더스 코리아(주),남자,남자,여자,1
2211,마녀,2018-06-27,2018-07-12,15,2678,683,358568,17.0,497275700,17808236171,61009,2089569,1,"미스터리,액션",워너브러더스 코리아(주),남자,남자,여자,1
2212,마녀,2018-06-27,2018-07-13,16,2648,677,359747,22.1,700847639,18509083810,79406,2168975,1,"미스터리,액션",워너브러더스 코리아(주),남자,남자,여자,1
2213,마녀,2018-06-27,2018-07-14,17,2964,751,407874,39.4,1424735635,19933819445,160607,2329582,1,"미스터리,액션",워너브러더스 코리아(주),남자,남자,여자,1
2214,마녀,2018-06-27,2018-07-15,18,2945,756,406117,36.3,1314404000,21248223445,147295,2476877,1,"미스터리,액션",워너브러더스 코리아(주),남자,남자,여자,1
2215,마녀,2018-06-27,2018-07-16,19,2918,724,407234,13.4,442050200,21690273645,54579,2531456,1,"미스터리,액션",워너브러더스 코리아(주),남자,남자,여자,1
2216,마녀,2018-06-27,2018-07-17,20,2938,728,409266,12.5,412827700,22103101345,51203,2582659,1,"미스터리,액션",워너브러더스 코리아(주),남자,남자,여자,1
2217,마녀,2018-06-27,2018-07-18,21,2093,582,277712,17.9,397974500,22501075845,49738,2632397,1,"미스터리,액션",워너브러더스 코리아(주),남자,남자,여자,1
2218,마녀,2018-06-27,2018-07-19,22,2023,591,270430,17.4,376008400,22877084245,47058,2679455,1,"미스터리,액션",워너브러더스 코리아(주),남자,남자,여자,1
2219,마녀,2018-06-27,2018-07-20,23,2256,648,305119,23.4,619524367,23496608612,71362,2750817,1,"미스터리,액션",워너브러더스 코리아(주),남자,남자,여자,1
2220,마녀,2018-06-27,2018-07-21,24,2482,750,348541,36.6,1133384451,24629993063,127555,2878372,1,"미스터리,액션",워너브러더스 코리아(주),남자,남자,여자,1
2221,마녀,2018-06-27,2018-07-22,25,2458,757,348717,35.0,1090795500,25720788563,121909,3000281,1,"미스터리,액션",워너브러더스 코리아(주),남자,남자,여자,1
2222,마녀,2018-06-27,2018-07-23,26,2579,691,365642,14.1,410781900,26131570463,51378,3051659,1,"미스터리,액션",워너브러더스 코리아(주),남자,남자,여자,1
2223,마녀,2018-06-27,2018-07-24,27,2568,697,364670,13.6,392066500,26523636963,49582,3101241,1,"미스터리,액션",워너브러더스 코리아(주),남자,남자,여자,1
2224,마녀,2018-06-27,2018-07-25,28,563,319,66592,21.5,91393900,26615030863,14300,3115541,1,"미스터리,액션",워너브러더스 코리아(주),남자,남자,여자,1
2225,마녀,2018-06-27,2018-07-26,29,505,279,59750,16.2,76941200,26691972063,9648,3125189,1,"미스터리,액션",워너브러더스 코리아(주),남자,남자,여자,1
2226,마녀,2018-06-27,2018-07-27,30,472,263,57081,17.4,87176200,26779148263,9927,3135116,1,"미스터리,액션",워너브러더스 코리아(주),남자,남자,여자,1
2227,마녀,2018-06-27,2018-07-28,31,386,235,46143,31.9,132116100,26911264363,14724,3149840,1,"미스터리,액션",워너브러더스 코리아(주),남자,남자,여자,1
2228,마녀,2018-06-27,2018-07-29,32,404,256,48743,28.9,125658100,27036922463,14078,3163918,1,"미스터리,액션",워너브러더스 코리아(주),남자,남자,여자,1
2229,마녀,2018-06-27,2018-07-30,33,450,265,54703,20.0,89940400,27126862863,10961,3174879,1,"미스터리,액션",워너브러더스 코리아(주),남자,남자,여자,1
2230,마녀,2018-06-27,2018-07-31,34,444,258,53775,21.5,93576700,27220439563,11551,3186430,1,"미스터리,액션",워너브러더스 코리아(주),남자,남자,여자,1
2231,마녀,2018-06-27,2018-08-01,35,30,24,3838,11.9,3634600,27224074163,457,3186887,1,"미스터리,액션",워너브러더스 코리아(주),남자,남자,여자,1
2232,마녀,2018-06-27,2018-08-02,36,34,26,4709,10.3,3918900,27227993063,484,3187371,1,"미스터리,액션",워너브러더스 코리아(주),남자,남자,여자,1
2233,마녀,2018-06-27,2018-08-03,37,19,15,2535,14.8,3203100,27231196163,375,3187746,1,"미스터리,액션",워너브러더스 코리아(주),남자,남자,여자,1
2234,마녀,2018-06-27,2018-08-04,38,21,16,3082,12.0,2975300,27234171463,370,3188116,1,"미스터리,액션",워너브러더스 코리아(주),남자,남자,여자,1
2235,마녀,2018-06-27,2018-08-05,39,19,17,3091,9.4,2409600,27236581063,289,3188405,1,"미스터리,액션",워너브러더스 코리아(주),남자,남자,여자,1
2236,마녀,2018-06-27,2018-08-06,40,18,16,2356,9.9,1729100,27238310163,232,3188637,1,"미스터리,액션",워너브러더스 코리아(주),남자,남자,여자,1
2237,마녀,2018-06-27,2018-08-07,41,23,17,3250,6.1,1523300,27239833463,197,3188834,1,"미스터리,액션",워너브러더스 코리아(주),남자,남자,여자,1
2238,마녀,2018-06-27,2018-08-08,42,1,1,92,17.4,115000,27239948463,16,3188850,1,"미스터리,액션",워너브러더스 코리아(주),남자,남자,여자,1
2239,마녀,2018-06-27,2018-08-09,43,1,1,92,25.0,191000,27240139463,23,3188873,1,"미스터리,액션",워너브러더스 코리아(주),남자,남자,여자,1
2240,마녀,2018-06-27,2018-08-10,44,1,1,92,26.1,193000,27240332463,24,3188897,1,"미스터리,액션",워너브러더스 코리아(주),남자,남자,여자,1
2241,마녀,2018-06-27,2018-08-11,45,1,1,84,51.2,397000,27240729463,43,3188940,1,"미스터리,액션",워너브러더스 코리아(주),남자,남자,여자,1
2242,마녀,2018-06-27,2018-08-12,46,1,1,92,31.5,265000,27240994463,29,3188969,1,"미스터리,액션",워너브러더스 코리아(주),남자,남자,여자,1
2243,마녀,2018-06-27,2018-08-13,47,1,1,92,10.9,87000,27241081463,10,3188979,1,"미스터리,액션",워너브러더스 코리아(주),남자,남자,여자,1
2244,마녀,2018-06-27,2018-08-14,48,1,1,92,16.3,115000,27241196463,15,3188994,1,"미스터리,액션",워너브러더스 코리아(주),남자,남자,여자,1
2245,마녀,2018-06-27,2018-08-15,49,1,1,92,30.4,236000,27241432463,28,3189022,1,"미스터리,액션",워너브러더스 코리아(주),남자,남자,여자,1
2246,마녀,2018-06-27,2018-08-16,50,1,1,92,12.0,96000,27241528463,11,3189033,1,"미스터리,액션",워너브러더스 코리아(주),남자,남자,여자,1
2247,마녀,2018-06-27,2018-08-17,51,1,1,92,12.0,90000,27241618463,11,3189044,1,"미스터리,액션",워너브러더스 코리아(주),남자,남자,여자,1
2248,마녀,2018-06-27,2018-08-18,52,1,1,92,17.4,144000,27241762463,16,3189060,1,"미스터리,액션",워너브러더스 코리아(주),남자,남자,여자,1
2249,마녀,2018-06-27,2018-08-19,53,1,1,92,10.9,100000,27241862463,10,3189070,1,"미스터리,액션",워너브러더스 코리아(주),남자,남자,여자,1
2250,마녀,2018-06-27,2018-08-20,54,1,1,92,5.4,45000,27241907463,5,3189075,1,"미스터리,액션",워너브러더스 코리아(주),남자,남자,여자,1
2251,마녀,2018-06-27,2018-08-21,55,1,1,92,9.8,65000,27241972463,9,3189084,1,"미스터리,액션",워너브러더스 코리아(주),남자,남자,여자,1
2252,마녀,2018-06-27,2018-08-22,56,1,1,92,7.6,57000,27242029463,7,3189091,1,"미스터리,액션",워너브러더스 코리아(주),남자,남자,여자,1
2253,마녀,2018-06-27,2018-11-12,138,1,1,85,0.0,0,27242029463,0,3189091,1,"미스터리,액션",워너브러더스 코리아(주),남자,남자,여자,1
2254,마녀,2018-06-27,2018-11-16,142,1,1,85,0.0,0,27242029463,0,3189091,1,"미스터리,액션",워너브러더스 코리아(주),남자,남자,여자,1
2255,목격자,2018-08-15,2018-07-18,-28,1,1,247,100.0,1729000,1729000,247,247,0,스릴러,(주)넥스트엔터테인먼트월드(NEW),남자,남자,남자,0
2256,목격자,2018-08-15,2018-08-06,-9,12,11,2769,92.7,23112000,24841000,2568,2815,0,스릴러,(주)넥스트엔터테인먼트월드(NEW),남자,남자,남자,0
2257,목격자,2018-08-15,2018-08-07,-8,30,30,6531,99.3,59448000,84289000,6485,9300,0,스릴러,(주)넥스트엔터테인먼트월드(NEW),남자,남자,남자,0
2258,목격자,2018-08-15,2018-08-08,-7,37,37,8275,98.5,75995000,160284000,8150,17450,0,스릴러,(주)넥스트엔터테인먼트월드(NEW),남자,남자,남자,0
2259,목격자,2018-08-15,2018-08-09,-6,18,18,3660,98.8,31264000,191548000,3616,21066,0,스릴러,(주)넥스트엔터테인먼트월드(NEW),남자,남자,남자,0
2260,목격자,2018-08-15,2018-08-14,-1,24,24,3543,85.1,22230800,213778800,3014,24080,0,스릴러,(주)넥스트엔터테인먼트월드(NEW),남자,남자,남자,0
2261,목격자,2018-08-15,2018-08-15,0,3539,808,533645,69.1,3195156400,3408935200,368981,393061,0,스릴러,(주)넥스트엔터테인먼트월드(NEW),남자,남자,남자,0
2262,목격자,2018-08-15,2018-08-16,1,3605,808,548842,29.5,1303703300,4712638500,161783,554844,0,스릴러,(주)넥스트엔터테인먼트월드(NEW),남자,남자,남자,0
2263,목격자,2018-08-15,2018-08-17,2,3868,868,595858,29.8,1578674964,6291313464,177251,732095,0,스릴러,(주)넥스트엔터테인먼트월드(NEW),남자,남자,남자,0
2264,목격자,2018-08-15,2018-08-18,3,4337,1005,697043,48.0,2966536796,9257850260,334388,1066483,0,스릴러,(주)넥스트엔터테인먼트월드(NEW),남자,남자,남자,0
2265,목격자,2018-08-15,2018-08-19,4,4335,1021,697000,42.9,2676107300,11933957560,298946,1365429,0,스릴러,(주)넥스트엔터테인먼트월드(NEW),남자,남자,남자,0
2266,목격자,2018-08-15,2018-08-20,5,4244,971,697613,18.4,995803000,12929760560,128512,1493941,0,스릴러,(주)넥스트엔터테인먼트월드(NEW),남자,남자,남자,0
2267,목격자,2018-08-15,2018-08-21,6,4185,938,686859,15.9,893602800,13823363360,109251,1603192,0,스릴러,(주)넥스트엔터테인먼트월드(NEW),남자,남자,남자,0
2268,목격자,2018-08-15,2018-08-22,7,3709,840,649818,14.4,759763800,14583127160,93526,1696718,0,스릴러,(주)넥스트엔터테인먼트월드(NEW),남자,남자,남자,0
2269,목격자,2018-08-15,2018-08-23,8,3340,806,597382,11.3,556800700,15139927860,67553,1764271,0,스릴러,(주)넥스트엔터테인먼트월드(NEW),남자,남자,남자,0
2270,목격자,2018-08-15,2018-08-24,9,3531,842,634749,15.2,882179500,16022107360,96627,1860898,0,스릴러,(주)넥스트엔터테인먼트월드(NEW),남자,남자,남자,0
2271,목격자,2018-08-15,2018-08-25,10,3697,845,666040,27.3,1640225300,17662332660,181657,2042555,0,스릴러,(주)넥스트엔터테인먼트월드(NEW),남자,남자,남자,0
2272,목격자,2018-08-15,2018-08-26,11,3579,819,642886,24.1,1410135300,19072467960,154660,2197215,0,스릴러,(주)넥스트엔터테인먼트월드(NEW),남자,남자,남자,0
2273,목격자,2018-08-15,2018-08-27,12,3346,778,586936,7.6,367230800,19439698760,44786,2242001,0,스릴러,(주)넥스트엔터테인먼트월드(NEW),남자,남자,남자,0
2274,목격자,2018-08-15,2018-08-28,13,3297,779,581052,7.2,342467500,19782166260,41972,2283973,0,스릴러,(주)넥스트엔터테인먼트월드(NEW),남자,남자,남자,0
2275,목격자,2018-08-15,2018-08-29,14,2144,605,324400,13.4,268763000,20050929260,43373,2327346,0,스릴러,(주)넥스트엔터테인먼트월드(NEW),남자,남자,남자,0
2276,목격자,2018-08-15,2018-08-30,15,1984,552,294513,8.2,195196800,20246126060,24199,2351545,0,스릴러,(주)넥스트엔터테인먼트월드(NEW),남자,남자,남자,0
2277,목격자,2018-08-15,2018-08-31,16,1980,561,288611,9.7,247050400,20493176460,27981,2379526,0,스릴러,(주)넥스트엔터테인먼트월드(NEW),남자,남자,남자,0
2278,목격자,2018-08-15,2018-09-01,17,1776,571,247903,14.7,326316587,20819493047,36502,2416028,0,스릴러,(주)넥스트엔터테인먼트월드(NEW),남자,남자,남자,0
2279,목격자,2018-08-15,2018-09-02,18,1716,567,238344,15.8,336431000,21155924047,37610,2453638,0,스릴러,(주)넥스트엔터테인먼트월드(NEW),남자,남자,남자,0
2280,목격자,2018-08-15,2018-09-03,19,1555,515,218912,5.3,92578050,21248502097,11575,2465213,0,스릴러,(주)넥스트엔터테인먼트월드(NEW),남자,남자,남자,0
2281,목격자,2018-08-15,2018-09-04,20,1452,515,204812,4.7,75914700,21324416797,9560,2474773,0,스릴러,(주)넥스트엔터테인먼트월드(NEW),남자,남자,남자,0
2282,목격자,2018-08-15,2018-09-05,21,1363,495,190653,4.6,68923050,21393339847,8710,2483483,0,스릴러,(주)넥스트엔터테인먼트월드(NEW),남자,남자,남자,0
2283,목격자,2018-08-15,2018-09-06,22,761,371,95171,5.6,42394900,21435734747,5290,2488773,0,스릴러,(주)넥스트엔터테인먼트월드(NEW),남자,남자,남자,0
2284,목격자,2018-08-15,2018-09-07,23,786,384,96839,6.1,51475450,21487210197,5883,2494656,0,스릴러,(주)넥스트엔터테인먼트월드(NEW),남자,남자,남자,0
2285,목격자,2018-08-15,2018-09-08,24,722,375,88533,10.4,81465700,21568675897,9233,2503889,0,스릴러,(주)넥스트엔터테인먼트월드(NEW),남자,남자,남자,0
2286,목격자,2018-08-15,2018-09-09,25,677,361,82722,10.0,66995500,21635671397,8270,2512159,0,스릴러,(주)넥스트엔터테인먼트월드(NEW),남자,남자,남자,0
2287,목격자,2018-08-15,2018-09-10,26,564,311,70571,5.2,30356700,21666028097,3648,2515807,0,스릴러,(주)넥스트엔터테인먼트월드(NEW),남자,남자,남자,0
2288,목격자,2018-08-15,2018-09-11,27,572,333,70231,5.3,30444350,21696472447,3709,2519516,0,스릴러,(주)넥스트엔터테인먼트월드(NEW),남자,남자,남자,0
2289,목격자,2018-08-15,2018-09-12,28,83,59,10547,12.6,11673100,21708145547,1329,2520845,0,스릴러,(주)넥스트엔터테인먼트월드(NEW),남자,남자,남자,0
2290,목격자,2018-08-15,2018-09-13,29,76,54,9607,2.7,2035750,21710181297,255,2521100,0,스릴러,(주)넥스트엔터테인먼트월드(NEW),남자,남자,남자,0
2291,목격자,2018-08-15,2018-09-14,30,83,62,9834,3.3,2821600,21713002897,327,2521427,0,스릴러,(주)넥스트엔터테인먼트월드(NEW),남자,남자,남자,0
2292,목격자,2018-08-15,2018-09-15,31,95,64,11466,5.7,5888000,21718890897,654,2522081,0,스릴러,(주)넥스트엔터테인먼트월드(NEW),남자,남자,남자,0
2293,목격자,2018-08-15,2018-09-16,32,96,63,11717,5.5,5850500,21724741397,648,2522729,0,스릴러,(주)넥스트엔터테인먼트월드(NEW),남자,남자,남자,0
2294,목격자,2018-08-15,2018-09-17,33,81,57,10270,2.9,2211600,21726952997,293,2523022,0,스릴러,(주)넥스트엔터테인먼트월드(NEW),남자,남자,남자,0
2295,목격자,2018-08-15,2018-09-18,34,80,60,9950,7.5,4184600,21731137597,748,2523770,0,스릴러,(주)넥스트엔터테인먼트월드(NEW),남자,남자,남자,0
2296,목격자,2018-08-15,2018-09-19,35,3,3,315,18.7,289000,21731426597,59,2523829,0,스릴러,(주)넥스트엔터테인먼트월드(NEW),남자,남자,남자,0
2297,목격자,2018-08-15,2018-09-20,36,13,13,1387,30.3,1975000,21733401597,420,2524249,0,스릴러,(주)넥스트엔터테인먼트월드(NEW),남자,남자,남자,0
2298,목격자,2018-08-15,2018-09-21,37,4,4,505,16.6,370000,21733771597,84,2524333,0,스릴러,(주)넥스트엔터테인먼트월드(NEW),남자,남자,남자,0
2299,목격자,2018-08-15,2018-10-30,76,1,1,160,80.6,1096500,21734868097,129,2524462,0,스릴러,(주)넥스트엔터테인먼트월드(NEW),남자,남자,남자,0
2300,목격자,2018-08-15,2018-10-31,77,1,1,132,97.7,1096500,21735964597,129,2524591,0,스릴러,(주)넥스트엔터테인먼트월드(NEW),남자,남자,남자,0
2301,목격자,2018-08-15,2018-11-01,78,1,1,132,97.7,1096500,21737061097,129,2524720,0,스릴러,(주)넥스트엔터테인먼트월드(NEW),남자,남자,남자,0
2302,공작,2018-08-08,2018-07-25,-14,1,1,200,100.0,1790000,1790000,200,200,0,드라마,씨제이이앤엠(주),남자,남자,남자,0
2303,공작,2018-08-08,2018-07-31,-8,13,9,3270,93.3,27491000,29281000,3051,3251,0,드라마,씨제이이앤엠(주),남자,남자,남자,0
2304,공작,2018-08-08,2018-08-01,-7,2,1,494,75.1,3339000,32620000,371,3622,0,드라마,씨제이이앤엠(주),남자,남자,남자,0
2305,공작,2018-08-08,2018-08-02,-6,8,6,2925,148.7,40394000,73014000,4348,7970,0,드라마,씨제이이앤엠(주),남자,남자,남자,0
2306,공작,2018-08-08,2018-08-03,-5,1,1,432,99.3,4575000,77589000,429,8399,0,드라마,씨제이이앤엠(주),남자,남자,남자,0
2307,공작,2018-08-08,2018-08-06,-2,27,27,5698,79.6,50519900,128108900,4538,12937,0,드라마,씨제이이앤엠(주),남자,남자,남자,0
2308,공작,2018-08-08,2018-08-07,-1,10,10,2180,99.1,19252000,147360900,2160,15097,0,드라마,씨제이이앤엠(주),남자,남자,남자,0
2309,공작,2018-08-08,2018-08-08,0,3835,934,589877,56.5,2638788700,2786149600,333316,348413,0,드라마,씨제이이앤엠(주),남자,남자,남자,0
2310,공작,2018-08-08,2018-08-09,1,4329,1103,668506,43.9,2351984800,5138134400,293161,641574,0,드라마,씨제이이앤엠(주),남자,남자,남자,0
2311,공작,2018-08-08,2018-08-10,2,4864,1204,769788,41.5,2839218145,7977352545,319083,960657,0,드라마,씨제이이앤엠(주),남자,남자,남자,0
2312,공작,2018-08-08,2018-08-11,3,5397,1304,864737,65.5,5051345741,13028698286,566483,1527140,0,드라마,씨제이이앤엠(주),남자,남자,남자,0
2313,공작,2018-08-08,2018-08-12,4,5375,1317,866261,62.3,4822205300,17850903586,539350,2066490,0,드라마,씨제이이앤엠(주),남자,남자,남자,0
2314,공작,2018-08-08,2018-08-13,5,5342,1218,898922,28.6,2080080600,19930984186,256834,2323324,0,드라마,씨제이이앤엠(주),남자,남자,남자,0
2315,공작,2018-08-08,2018-08-14,6,5464,1265,923083,32.5,2430181900,22361166086,299991,2623315,0,드라마,씨제이이앤엠(주),남자,남자,남자,0
2316,공작,2018-08-08,2018-08-15,7,4584,1112,828664,57.5,4213335700,26574501786,476029,3099344,0,드라마,씨제이이앤엠(주),남자,남자,남자,0
2317,공작,2018-08-08,2018-08-16,8,4337,1028,790897,20.3,1297051700,27871553486,160322,3259666,0,드라마,씨제이이앤엠(주),남자,남자,남자,0
2318,공작,2018-08-08,2018-08-17,9,4364,1038,796454,20.7,1484277136,29355830622,164591,3424257,0,드라마,씨제이이앤엠(주),남자,남자,남자,0
2319,공작,2018-08-08,2018-08-18,10,4335,1051,793233,41.6,2987053654,32342884276,330041,3754298,0,드라마,씨제이이앤엠(주),남자,남자,남자,0
2320,공작,2018-08-08,2018-08-19,11,4210,1016,773147,37.2,2597465100,34940349376,287278,4041576,0,드라마,씨제이이앤엠(주),남자,남자,남자,0
2321,공작,2018-08-08,2018-08-20,12,3944,959,714148,12.8,743465900,35683815276,91225,4132801,0,드라마,씨제이이앤엠(주),남자,남자,남자,0
2322,공작,2018-08-08,2018-08-21,13,3920,974,713614,12.3,714934800,36398750076,87838,4220639,0,드라마,씨제이이앤엠(주),남자,남자,남자,0
2323,공작,2018-08-08,2018-08-22,14,3124,836,551369,12.7,561443200,36960193276,69826,4290465,0,드라마,씨제이이앤엠(주),남자,남자,남자,0
2324,공작,2018-08-08,2018-08-23,15,2749,784,474670,11.5,446703600,37406896876,54462,4344927,0,드라마,씨제이이앤엠(주),남자,남자,남자,0
2325,공작,2018-08-08,2018-08-24,16,2825,797,477882,15.6,681488800,38088385676,74448,4419375,0,드라마,씨제이이앤엠(주),남자,남자,남자,0
2326,공작,2018-08-08,2018-08-25,17,2727,746,446771,29.1,1183075900,39271461576,129922,4549297,0,드라마,씨제이이앤엠(주),남자,남자,남자,0
2327,공작,2018-08-08,2018-08-26,18,2640,732,432990,26.2,1032107300,40303568876,113325,4662622,0,드라마,씨제이이앤엠(주),남자,남자,남자,0
2328,공작,2018-08-08,2018-08-27,19,2538,725,403416,9.3,299865100,40603433976,37333,4699955,0,드라마,씨제이이앤엠(주),남자,남자,남자,0
2329,공작,2018-08-08,2018-08-28,20,2486,724,393390,9.3,290156300,40893590276,36399,4736354,0,드라마,씨제이이앤엠(주),남자,남자,남자,0
2330,공작,2018-08-08,2018-08-29,21,1406,570,190866,18.4,216588400,41110178676,35128,4771482,0,드라마,씨제이이앤엠(주),남자,남자,남자,0
2331,공작,2018-08-08,2018-08-30,22,1365,519,183731,11.7,169996400,41280175076,21573,4793055,0,드라마,씨제이이앤엠(주),남자,남자,남자,0
2332,공작,2018-08-08,2018-08-31,23,1361,525,181791,13.2,207894300,41488069376,24071,4817126,0,드라마,씨제이이앤엠(주),남자,남자,남자,0
2333,공작,2018-08-08,2018-09-01,24,1296,536,171494,17.2,260248000,41748317376,29573,4846699,0,드라마,씨제이이앤엠(주),남자,남자,남자,0
2334,공작,2018-08-08,2018-09-02,25,1222,514,161167,20.4,293121400,42041438776,32887,4879586,0,드라마,씨제이이앤엠(주),남자,남자,남자,0
2335,공작,2018-08-08,2018-09-03,26,1185,516,159546,7.3,90816700,42132255476,11584,4891170,0,드라마,씨제이이앤엠(주),남자,남자,남자,0
2336,공작,2018-08-08,2018-09-04,27,1148,515,151765,6.8,79771300,42212026776,10306,4901476,0,드라마,씨제이이앤엠(주),남자,남자,남자,0
2337,공작,2018-08-08,2018-09-05,28,1103,480,144854,6.1,68943700,42280970476,8865,4910341,0,드라마,씨제이이앤엠(주),남자,남자,남자,0
2338,공작,2018-08-08,2018-09-06,29,689,361,84213,7.6,48562100,42329532576,6365,4916706,0,드라마,씨제이이앤엠(주),남자,남자,남자,0
2339,공작,2018-08-08,2018-09-07,30,708,367,86143,8.5,62162200,42391694776,7305,4924011,0,드라마,씨제이이앤엠(주),남자,남자,남자,0
2340,공작,2018-08-08,2018-09-08,31,692,375,86943,14.5,110964600,42502659376,12580,4936591,0,드라마,씨제이이앤엠(주),남자,남자,남자,0
2341,공작,2018-08-08,2018-09-09,32,668,363,83498,15.6,103051450,42605710826,12994,4949585,0,드라마,씨제이이앤엠(주),남자,남자,남자,0
2342,공작,2018-08-08,2018-09-10,33,652,365,79921,5.4,33462900,42639173726,4331,4953916,0,드라마,씨제이이앤엠(주),남자,남자,남자,0
2343,공작,2018-08-08,2018-09-11,34,686,387,84595,6.3,37874050,42677047776,5328,4959244,0,드라마,씨제이이앤엠(주),남자,남자,남자,0
2344,공작,2018-08-08,2018-09-12,35,179,130,20959,5.6,8687700,42685735476,1181,4960425,0,드라마,씨제이이앤엠(주),남자,남자,남자,0
2345,공작,2018-08-08,2018-09-13,36,180,139,21307,8.5,11323300,42697058776,1801,4962226,0,드라마,씨제이이앤엠(주),남자,남자,남자,0
2346,공작,2018-08-08,2018-09-14,37,178,133,20862,6.5,10776100,42707834876,1363,4963589,0,드라마,씨제이이앤엠(주),남자,남자,남자,0
2347,공작,2018-08-08,2018-09-15,38,187,138,21320,12.1,22337750,42730172626,2586,4966175,0,드라마,씨제이이앤엠(주),남자,남자,남자,0
2348,공작,2018-08-08,2018-09-16,39,178,131,20598,10.4,18382900,42748555526,2150,4968325,0,드라마,씨제이이앤엠(주),남자,남자,남자,0
2349,공작,2018-08-08,2018-09-17,40,167,118,19943,5.6,7760350,42756315876,1117,4969442,0,드라마,씨제이이앤엠(주),남자,남자,남자,0
2350,공작,2018-08-08,2018-09-18,41,165,123,19924,5.1,7665300,42763981176,1011,4970453,0,드라마,씨제이이앤엠(주),남자,남자,남자,0
2351,공작,2018-08-08,2018-09-19,42,10,9,1129,16.4,968000,42764949176,185,4970638,0,드라마,씨제이이앤엠(주),남자,남자,남자,0
2352,공작,2018-08-08,2018-09-20,43,15,14,1834,44.3,5302000,42770251176,812,4971450,0,드라마,씨제이이앤엠(주),남자,남자,남자,0
2353,공작,2018-08-08,2018-09-21,44,7,7,1062,16.0,907000,42771158176,170,4971620,0,드라마,씨제이이앤엠(주),남자,남자,남자,0
2354,공작,2018-08-08,2018-09-22,45,6,6,789,23.8,1102000,42772260176,188,4971808,0,드라마,씨제이이앤엠(주),남자,남자,남자,0
2355,공작,2018-08-08,2018-09-23,46,7,7,830,22.9,1116000,42773376176,190,4971998,0,드라마,씨제이이앤엠(주),남자,남자,남자,0
2356,공작,2018-08-08,2018-09-24,47,9,9,946,26.1,1625000,42775001176,247,4972245,0,드라마,씨제이이앤엠(주),남자,남자,남자,0
2357,공작,2018-08-08,2018-09-25,48,8,8,880,26.5,1417000,42776418176,233,4972478,0,드라마,씨제이이앤엠(주),남자,남자,남자,0
2358,공작,2018-08-08,2018-09-26,49,6,6,760,26.8,1203000,42777621176,204,4972682,0,드라마,씨제이이앤엠(주),남자,남자,남자,0
2359,공작,2018-08-08,2018-09-27,50,8,8,1019,22.9,1194000,42778815176,233,4972915,0,드라마,씨제이이앤엠(주),남자,남자,남자,0
2360,공작,2018-08-08,2018-09-28,51,7,7,917,17.0,797000,42779612176,156,4973071,0,드라마,씨제이이앤엠(주),남자,남자,남자,0
2361,공작,2018-08-08,2018-09-29,52,7,7,918,18.1,870000,42780482176,166,4973237,0,드라마,씨제이이앤엠(주),남자,남자,남자,0
2362,공작,2018-08-08,2018-09-30,53,7,7,963,18.7,1019000,42781501176,180,4973417,0,드라마,씨제이이앤엠(주),남자,남자,남자,0
2363,공작,2018-08-08,2018-10-01,54,7,7,964,16.9,819000,42782320176,163,4973580,0,드라마,씨제이이앤엠(주),남자,남자,남자,0
2364,공작,2018-08-08,2018-10-02,55,7,7,1091,14.4,798000,42783118176,157,4973737,0,드라마,씨제이이앤엠(주),남자,남자,남자,0
2365,공작,2018-08-08,2018-10-03,56,6,6,952,17.4,895000,42784013176,166,4973903,0,드라마,씨제이이앤엠(주),남자,남자,남자,0
2366,공작,2018-08-08,2018-10-10,63,1,1,114,1.8,10000,42784023176,2,4973905,0,드라마,씨제이이앤엠(주),남자,남자,남자,0
2367,공작,2018-08-08,2018-10-11,64,2,2,304,3.6,55000,42784078176,11,4973916,0,드라마,씨제이이앤엠(주),남자,남자,남자,0
2368,공작,2018-08-08,2018-10-12,65,1,1,114,6.1,35000,42784113176,7,4973923,0,드라마,씨제이이앤엠(주),남자,남자,남자,0
2369,공작,2018-08-08,2018-10-13,66,1,1,114,5.3,30000,42784143176,6,4973929,0,드라마,씨제이이앤엠(주),남자,남자,남자,0
2370,공작,2018-08-08,2018-10-14,67,1,1,114,7.0,40000,42784183176,8,4973937,0,드라마,씨제이이앤엠(주),남자,남자,남자,0
2371,공작,2018-08-08,2018-10-15,68,1,1,114,2.6,15000,42784198176,3,4973940,0,드라마,씨제이이앤엠(주),남자,남자,남자,0
2372,공작,2018-08-08,2018-10-16,69,1,1,114,2.6,15000,42784213176,3,4973943,0,드라마,씨제이이앤엠(주),남자,남자,남자,0
2373,공작,2018-08-08,2018-10-17,70,2,2,200,39.5,472000,42784685176,79,4974022,0,드라마,씨제이이앤엠(주),남자,남자,남자,0
2374,공작,2018-08-08,2018-10-19,72,1,1,212,0.0,0,42784685176,0,4974022,0,드라마,씨제이이앤엠(주),남자,남자,남자,0
2375,공작,2018-08-08,2018-10-27,80,1,1,318,100.0,2544000,42787229176,318,4974340,0,드라마,씨제이이앤엠(주),남자,남자,남자,0
2376,공작,2018-08-08,2018-10-30,83,1,1,132,43.2,484500,42787713676,57,4974397,0,드라마,씨제이이앤엠(주),남자,남자,남자,0
2377,공작,2018-08-08,2018-10-31,84,1,1,231,24.7,484500,42788198176,57,4974454,0,드라마,씨제이이앤엠(주),남자,남자,남자,0
2378,공작,2018-08-08,2018-11-01,85,1,1,360,16.1,493000,42788691176,58,4974512,0,드라마,씨제이이앤엠(주),남자,남자,남자,0
2379,공작,2018-08-08,2018-11-13,97,1,1,85,0.0,0,42788691176,0,4974512,0,드라마,씨제이이앤엠(주),남자,남자,남자,0
2380,공작,2018-08-08,2018-11-17,101,1,1,85,0.0,0,42788691176,0,4974512,0,드라마,씨제이이앤엠(주),남자,남자,남자,0
2381,공작,2018-08-08,2018-12-29,143,1,1,8,100.0,160000,42788851176,8,4974520,0,드라마,씨제이이앤엠(주),남자,남자,남자,0
2382,공작,2018-08-08,2019-03-31,235,1,1,332,100.0,2324000,42791175176,332,4974852,0,드라마,씨제이이앤엠(주),남자,남자,남자,0
2383,공작,2018-08-08,2019-04-27,262,1,1,8,100.0,88000,42791263176,8,4974860,0,드라마,씨제이이앤엠(주),남자,남자,남자,0
2384,공작,2018-08-08,2019-05-08,273,22,22,2828,1.9,353100,42791616276,55,4974915,0,드라마,씨제이이앤엠(주),남자,남자,남자,0
2385,공작,2018-08-08,2019-05-09,274,12,12,1678,1.3,134600,42791750876,21,4974936,0,드라마,씨제이이앤엠(주),남자,남자,남자,0
2386,공작,2018-08-08,2019-05-10,275,16,16,2211,1.9,246300,42791997176,41,4974977,0,드라마,씨제이이앤엠(주),남자,남자,남자,0
2387,공작,2018-08-08,2019-05-11,276,13,13,1615,2.6,264800,42792261976,42,4975019,0,드라마,씨제이이앤엠(주),남자,남자,남자,0
2388,공작,2018-08-08,2019-05-12,277,10,10,1353,1.5,135500,42792397476,20,4975039,0,드라마,씨제이이앤엠(주),남자,남자,남자,0
2389,공작,2018-08-08,2019-05-13,278,21,21,2705,2.3,362800,42792760276,61,4975100,0,드라마,씨제이이앤엠(주),남자,남자,남자,0
2390,공작,2018-08-08,2019-05-14,279,20,20,2705,1.6,262600,42793022876,42,4975142,0,드라마,씨제이이앤엠(주),남자,남자,남자,0
2391,공작,2018-08-08,2019-06-08,304,1,1,202,25.7,509940,42793532816,52,4975194,0,드라마,씨제이이앤엠(주),남자,남자,남자,0
2392,공작,2018-08-08,2019-08-18,375,1,1,168,100.0,1008000,42794540816,168,4975362,0,드라마,씨제이이앤엠(주),남자,남자,남자,0
2393,공작,2018-08-08,2019-09-03,391,1,1,157,25.5,200000,42794740816,40,4975402,0,드라마,씨제이이앤엠(주),남자,남자,남자,0
2394,공작,2018-08-08,2019-09-04,392,1,1,157,25.5,200000,42794940816,40,4975442,0,드라마,씨제이이앤엠(주),남자,남자,남자,0
2395,공작,2018-08-08,2019-09-21,409,1,1,75,100.0,750000,42795690816,75,4975517,0,드라마,씨제이이앤엠(주),남자,남자,남자,0
2396,창궐,2018-10-25,2018-10-10,-15,1,1,383,100.0,3447000,3447000,383,383,0,"사극,액션",(주)넥스트엔터테인먼트월드(NEW),남자,남자,남자,0
2397,창궐,2018-10-25,2018-10-17,-8,4,4,1235,97.6,11228000,14675000,1205,1588,0,"사극,액션",(주)넥스트엔터테인먼트월드(NEW),남자,남자,남자,0
2398,창궐,2018-10-25,2018-10-18,-7,11,11,3255,100.0,22785000,37460000,3255,4843,0,"사극,액션",(주)넥스트엔터테인먼트월드(NEW),남자,남자,남자,0
2399,창궐,2018-10-25,2018-10-19,-6,12,12,2672,75.3,20331800,57791800,2012,6855,0,"사극,액션",(주)넥스트엔터테인먼트월드(NEW),남자,남자,남자,0
2400,창궐,2018-10-25,2018-10-22,-3,20,20,4529,38.6,20486100,78277900,1749,8604,0,"사극,액션",(주)넥스트엔터테인먼트월드(NEW),남자,남자,남자,0
2401,창궐,2018-10-25,2018-10-23,-2,2,2,361,100.0,3249000,81526900,361,8965,0,"사극,액션",(주)넥스트엔터테인먼트월드(NEW),남자,남자,남자,0
2402,창궐,2018-10-25,2018-10-24,-1,11,11,2951,81.5,19361000,100887900,2405,11370,0,"사극,액션",(주)넥스트엔터테인먼트월드(NEW),남자,남자,남자,0
2403,창궐,2018-10-25,2018-10-25,0,6237,1283,1159768,13.5,1238347750,1339235650,156629,167999,0,"사극,액션",(주)넥스트엔터테인먼트월드(NEW),남자,남자,남자,0
2404,창궐,2018-10-25,2018-10-26,1,6399,1304,1183275,17.3,1778473760,3117709410,204987,372986,0,"사극,액션",(주)넥스트엔터테인먼트월드(NEW),남자,남자,남자,0
2405,창궐,2018-10-25,2018-10-27,2,6908,1351,1282033,26.6,3050261104,6167970514,340570,713556,0,"사극,액션",(주)넥스트엔터테인먼트월드(NEW),남자,남자,남자,0
2406,창궐,2018-10-25,2018-10-28,3,6747,1309,1254848,23.5,2643350100,8811320614,295422,1008978,0,"사극,액션",(주)넥스트엔터테인먼트월드(NEW),남자,남자,남자,0
2407,창궐,2018-10-25,2018-10-29,4,6363,1330,1177950,11.0,871590600,9682911214,128950,1137928,0,"사극,액션",(주)넥스트엔터테인먼트월드(NEW),남자,남자,남자,0
2408,창궐,2018-10-25,2018-10-30,5,6178,1239,1149505,7.2,647786850,10330698064,82772,1220700,0,"사극,액션",(주)넥스트엔터테인먼트월드(NEW),남자,남자,남자,0
2409,창궐,2018-10-25,2018-10-31,6,2824,802,452720,20.7,553678450,10884376514,93528,1314228,0,"사극,액션",(주)넥스트엔터테인먼트월드(NEW),남자,남자,남자,0
2410,창궐,2018-10-25,2018-11-01,7,2646,706,405589,8.5,268999550,11153376064,34487,1348715,0,"사극,액션",(주)넥스트엔터테인먼트월드(NEW),남자,남자,남자,0
2411,창궐,2018-10-25,2018-11-02,8,2657,711,407560,10.2,354507468,11507883532,41687,1390402,0,"사극,액션",(주)넥스트엔터테인먼트월드(NEW),남자,남자,남자,0
2412,창궐,2018-10-25,2018-11-03,9,2490,679,363901,20.6,659745758,12167629290,74884,1465286,0,"사극,액션",(주)넥스트엔터테인먼트월드(NEW),남자,남자,남자,0
2413,창궐,2018-10-25,2018-11-04,10,2317,650,333241,17.5,509413050,12677042340,58422,1523708,0,"사극,액션",(주)넥스트엔터테인먼트월드(NEW),남자,남자,남자,0
2414,창궐,2018-10-25,2018-11-05,11,2032,586,284171,5.4,120765700,12797808040,15360,1539068,0,"사극,액션",(주)넥스트엔터테인먼트월드(NEW),남자,남자,남자,0
2415,창궐,2018-10-25,2018-11-06,12,1945,580,270344,5.2,109591300,12907399340,14008,1553076,0,"사극,액션",(주)넥스트엔터테인먼트월드(NEW),남자,남자,남자,0
2416,창궐,2018-10-25,2018-11-07,13,1036,465,123271,6.4,61597050,12968996390,7908,1560984,0,"사극,액션",(주)넥스트엔터테인먼트월드(NEW),남자,남자,남자,0
2417,창궐,2018-10-25,2018-11-08,14,772,413,92489,6.2,43419900,13012416290,5711,1566695,0,"사극,액션",(주)넥스트엔터테인먼트월드(NEW),남자,남자,남자,0
2418,창궐,2018-10-25,2018-11-09,15,740,404,87531,6.9,48869400,13061285690,6034,1572729,0,"사극,액션",(주)넥스트엔터테인먼트월드(NEW),남자,남자,남자,0
2419,창궐,2018-10-25,2018-11-10,16,588,356,68220,12.2,70556850,13131842540,8324,1581053,0,"사극,액션",(주)넥스트엔터테인먼트월드(NEW),남자,남자,남자,0
2420,창궐,2018-10-25,2018-11-11,17,560,342,65727,11.2,63091950,13194934490,7390,1588443,0,"사극,액션",(주)넥스트엔터테인먼트월드(NEW),남자,남자,남자,0
2421,창궐,2018-10-25,2018-11-12,18,525,297,62040,3.9,18414250,13213348740,2413,1590856,0,"사극,액션",(주)넥스트엔터테인먼트월드(NEW),남자,남자,남자,0
2422,창궐,2018-10-25,2018-11-13,19,490,301,58701,7.3,36238650,13249587390,4255,1595111,0,"사극,액션",(주)넥스트엔터테인먼트월드(NEW),남자,남자,남자,0
2423,창궐,2018-10-25,2018-11-14,20,27,21,2684,23.2,4086300,13253673690,622,1595733,0,"사극,액션",(주)넥스트엔터테인먼트월드(NEW),남자,남자,남자,0
2424,창궐,2018-10-25,2018-11-15,21,11,8,1041,14.7,984000,13254657690,153,1595886,0,"사극,액션",(주)넥스트엔터테인먼트월드(NEW),남자,남자,남자,0
2425,창궐,2018-10-25,2018-11-16,22,11,7,885,28.8,1606000,13256263690,255,1596141,0,"사극,액션",(주)넥스트엔터테인먼트월드(NEW),남자,남자,남자,0
2426,창궐,2018-10-25,2018-11-17,23,6,4,431,17.2,578000,13256841690,74,1596215,0,"사극,액션",(주)넥스트엔터테인먼트월드(NEW),남자,남자,남자,0
2427,창궐,2018-10-25,2018-11-18,24,4,3,309,22.7,609000,13257450690,70,1596285,0,"사극,액션",(주)넥스트엔터테인먼트월드(NEW),남자,남자,남자,0
2428,창궐,2018-10-25,2018-11-19,25,9,6,1239,25.6,1636300,13259086990,317,1596602,0,"사극,액션",(주)넥스트엔터테인먼트월드(NEW),남자,남자,남자,0
2429,창궐,2018-10-25,2018-11-20,26,23,22,2989,29.3,4954000,13264040990,875,1597477,0,"사극,액션",(주)넥스트엔터테인먼트월드(NEW),남자,남자,남자,0
2430,창궐,2018-10-25,2018-11-21,27,8,7,916,3.3,261000,13264301990,30,1597507,0,"사극,액션",(주)넥스트엔터테인먼트월드(NEW),남자,남자,남자,0
2431,창궐,2018-10-25,2018-11-22,28,20,19,2488,32.6,4885500,13269187490,812,1598319,0,"사극,액션",(주)넥스트엔터테인먼트월드(NEW),남자,남자,남자,0
2432,창궐,2018-10-25,2018-11-23,29,8,8,1196,36.6,3035000,13272222490,438,1598757,0,"사극,액션",(주)넥스트엔터테인먼트월드(NEW),남자,남자,남자,0
2433,창궐,2018-10-25,2018-11-24,30,4,4,541,4.1,193000,13272415490,22,1598779,0,"사극,액션",(주)넥스트엔터테인먼트월드(NEW),남자,남자,남자,0
2434,창궐,2018-10-25,2018-11-25,31,4,4,554,4.2,204000,13272619490,23,1598802,0,"사극,액션",(주)넥스트엔터테인먼트월드(NEW),남자,남자,남자,0
2435,창궐,2018-10-25,2018-11-26,32,4,4,508,1.2,45000,13272664490,6,1598808,0,"사극,액션",(주)넥스트엔터테인먼트월드(NEW),남자,남자,남자,0
2436,창궐,2018-10-25,2018-11-27,33,8,8,863,14.3,669000,13273333490,123,1598931,0,"사극,액션",(주)넥스트엔터테인먼트월드(NEW),남자,남자,남자,0
2437,창궐,2018-10-25,2018-11-28,34,6,6,691,12.2,408000,13273741490,84,1599015,0,"사극,액션",(주)넥스트엔터테인먼트월드(NEW),남자,남자,남자,0
2438,창궐,2018-10-25,2018-11-29,35,5,5,588,11.6,373000,13274114490,68,1599083,0,"사극,액션",(주)넥스트엔터테인먼트월드(NEW),남자,남자,남자,0
2439,창궐,2018-10-25,2018-11-30,36,3,3,404,2.5,90000,13274204490,10,1599093,0,"사극,액션",(주)넥스트엔터테인먼트월드(NEW),남자,남자,남자,0
2440,창궐,2018-10-25,2018-12-01,37,3,3,404,1.5,53000,13274257490,6,1599099,0,"사극,액션",(주)넥스트엔터테인먼트월드(NEW),남자,남자,남자,0
2441,창궐,2018-10-25,2018-12-02,38,3,3,404,2.7,85000,13274342490,11,1599110,0,"사극,액션",(주)넥스트엔터테인먼트월드(NEW),남자,남자,남자,0
2442,창궐,2018-10-25,2018-12-03,39,2,2,309,0.7,13000,13274355490,2,1599112,0,"사극,액션",(주)넥스트엔터테인먼트월드(NEW),남자,남자,남자,0
2443,창궐,2018-10-25,2018-12-05,41,1,1,92,5.4,33000,13274388490,5,1599117,0,"사극,액션",(주)넥스트엔터테인먼트월드(NEW),남자,남자,남자,0
2444,창궐,2018-10-25,2018-12-07,43,2,2,173,100.0,1384000,13275772490,173,1599290,0,"사극,액션",(주)넥스트엔터테인먼트월드(NEW),남자,남자,남자,0
2445,창궐,2018-10-25,2019-01-18,85,2,2,358,86.0,2464000,13278236490,308,1599598,0,"사극,액션",(주)넥스트엔터테인먼트월드(NEW),남자,남자,남자,0
2446,말모이,2019-01-09,2018-11-27,-43,1,1,59,1.7,2000,2000,1,1,2,드라마,롯데컬처웍스(주)롯데엔터테인먼트,여자,여자,남자,2
2447,말모이,2019-01-09,2018-12-17,-23,1,1,262,100.0,2358000,2360000,262,263,2,드라마,롯데컬처웍스(주)롯데엔터테인먼트,여자,여자,남자,2
2448,말모이,2019-01-09,2018-12-18,-22,116,108,23038,98.9,118793000,121153000,22785,23048,2,드라마,롯데컬처웍스(주)롯데엔터테인먼트,여자,여자,남자,2
2449,말모이,2019-01-09,2018-12-19,-21,50,44,11769,98.3,57850000,179003000,11570,34618,2,드라마,롯데컬처웍스(주)롯데엔터테인먼트,여자,여자,남자,2
2450,말모이,2019-01-09,2018-12-20,-20,41,39,10207,99.3,56665000,235668000,10133,44751,2,드라마,롯데컬처웍스(주)롯데엔터테인먼트,여자,여자,남자,2
2451,말모이,2019-01-09,2018-12-21,-19,2,2,361,100.0,1805000,237473000,361,45112,2,드라마,롯데컬처웍스(주)롯데엔터테인먼트,여자,여자,남자,2
2452,말모이,2019-01-09,2018-12-22,-18,2,2,230,100.0,1840000,239313000,230,45342,2,드라마,롯데컬처웍스(주)롯데엔터테인먼트,여자,여자,남자,2
2453,말모이,2019-01-09,2018-12-27,-13,24,24,5165,99.3,39747000,279060000,5127,50469,2,드라마,롯데컬처웍스(주)롯데엔터테인먼트,여자,여자,남자,2
2454,말모이,2019-01-09,2018-12-28,-12,2,2,297,100.0,1485000,280545000,297,50766,2,드라마,롯데컬처웍스(주)롯데엔터테인먼트,여자,여자,남자,2
2455,말모이,2019-01-09,2018-12-29,-11,6,6,1361,100.0,11718000,292263000,1361,52127,2,드라마,롯데컬처웍스(주)롯데엔터테인먼트,여자,여자,남자,2
2456,말모이,2019-01-09,2018-12-30,-10,6,6,1237,100.0,11184000,303447000,1237,53364,2,드라마,롯데컬처웍스(주)롯데엔터테인먼트,여자,여자,남자,2
2457,말모이,2019-01-09,2018-12-31,-9,1,1,212,100.0,1060000,304507000,212,53576,2,드라마,롯데컬처웍스(주)롯데엔터테인먼트,여자,여자,남자,2
2458,말모이,2019-01-09,2019-01-02,-7,14,13,2661,84.7,11265000,315772000,2253,55829,2,드라마,롯데컬처웍스(주)롯데엔터테인먼트,여자,여자,남자,2
2459,말모이,2019-01-09,2019-01-03,-6,30,30,5998,57.1,29050500,344822500,3422,59251,2,드라마,롯데컬처웍스(주)롯데엔터테인먼트,여자,여자,남자,2
2460,말모이,2019-01-09,2019-01-04,-5,10,10,1772,99.9,10252000,355074500,1770,61021,2,드라마,롯데컬처웍스(주)롯데엔터테인먼트,여자,여자,남자,2
2461,말모이,2019-01-09,2019-01-05,-4,735,447,114264,37.5,383652650,738727150,42874,103895,2,드라마,롯데컬처웍스(주)롯데엔터테인먼트,여자,여자,남자,2
2462,말모이,2019-01-09,2019-01-06,-3,734,449,113101,42.5,433474450,1172201600,48084,151979,2,드라마,롯데컬처웍스(주)롯데엔터테인먼트,여자,여자,남자,2
2463,말모이,2019-01-09,2019-01-07,-2,35,35,7860,91.7,58290000,1230491600,7208,159187,2,드라마,롯데컬처웍스(주)롯데엔터테인먼트,여자,여자,남자,2
2464,말모이,2019-01-09,2019-01-08,-1,18,18,3509,95.0,16665000,1247156600,3333,162520,2,드라마,롯데컬처웍스(주)롯데엔터테인먼트,여자,여자,남자,2
2465,말모이,2019-01-09,2019-01-09,0,4853,1077,913424,13.4,984040250,2231196850,122458,284978,2,드라마,롯데컬처웍스(주)롯데엔터테인먼트,여자,여자,남자,2
2466,말모이,2019-01-09,2019-01-10,1,4761,1112,901486,12.7,915333400,3146530250,114367,399345,2,드라마,롯데컬처웍스(주)롯데엔터테인먼트,여자,여자,남자,2
2467,말모이,2019-01-09,2019-01-11,2,4932,1128,936743,14.8,1218285077,4364815327,138509,537854,2,드라마,롯데컬처웍스(주)롯데엔터테인먼트,여자,여자,남자,2
2468,말모이,2019-01-09,2019-01-12,3,5132,1203,959415,33.6,2851905264,7216720591,322741,860595,2,드라마,롯데컬처웍스(주)롯데엔터테인먼트,여자,여자,남자,2
2469,말모이,2019-01-09,2019-01-13,4,5007,1202,936464,34.6,2850305040,10067025631,324324,1184919,2,드라마,롯데컬처웍스(주)롯데엔터테인먼트,여자,여자,남자,2
2470,말모이,2019-01-09,2019-01-14,5,4766,1106,895330,12.5,897802890,10964828521,112027,1296946,2,드라마,롯데컬처웍스(주)롯데엔터테인먼트,여자,여자,남자,2
2471,말모이,2019-01-09,2019-01-15,6,4783,1116,893140,12.5,888051170,11852879691,111887,1408833,2,드라마,롯데컬처웍스(주)롯데엔터테인먼트,여자,여자,남자,2
2472,말모이,2019-01-09,2019-01-16,7,3993,1015,768300,14.0,845121470,12698001161,107579,1516412,2,드라마,롯데컬처웍스(주)롯데엔터테인먼트,여자,여자,남자,2
2473,말모이,2019-01-09,2019-01-17,8,3403,965,623046,14.5,719737710,13417738871,90529,1606941,2,드라마,롯데컬처웍스(주)롯데엔터테인먼트,여자,여자,남자,2
2474,말모이,2019-01-09,2019-01-18,9,3749,1021,686534,15.8,952212478,14369951349,108567,1715508,2,드라마,롯데컬처웍스(주)롯데엔터테인먼트,여자,여자,남자,2
2475,말모이,2019-01-09,2019-01-19,10,4305,1135,786209,33.1,2279623114,16649574463,259951,1975459,2,드라마,롯데컬처웍스(주)롯데엔터테인먼트,여자,여자,남자,2
2476,말모이,2019-01-09,2019-01-20,11,4279,1137,781045,31.9,2167597280,18817171743,249109,2224568,2,드라마,롯데컬처웍스(주)롯데엔터테인먼트,여자,여자,남자,2
2477,말모이,2019-01-09,2019-01-21,12,4038,1046,747684,11.0,648894960,19466066703,82069,2306637,2,드라마,롯데컬처웍스(주)롯데엔터테인먼트,여자,여자,남자,2
2478,말모이,2019-01-09,2019-01-22,13,4012,1081,741291,10.2,592247980,20058314683,75518,2382155,2,드라마,롯데컬처웍스(주)롯데엔터테인먼트,여자,여자,남자,2
2479,말모이,2019-01-09,2019-01-23,14,2837,807,417406,11.3,367555780,20425870463,47177,2429332,2,드라마,롯데컬처웍스(주)롯데엔터테인먼트,여자,여자,남자,2
2480,말모이,2019-01-09,2019-01-24,15,2702,827,393926,10.3,313423900,20739294363,40419,2469751,2,드라마,롯데컬처웍스(주)롯데엔터테인먼트,여자,여자,남자,2
2481,말모이,2019-01-09,2019-01-25,16,2716,826,392291,9.9,329164678,21068459041,38664,2508415,2,드라마,롯데컬처웍스(주)롯데엔터테인먼트,여자,여자,남자,2
2482,말모이,2019-01-09,2019-01-26,17,2562,810,350278,22.9,691611042,21760070083,80123,2588538,2,드라마,롯데컬처웍스(주)롯데엔터테인먼트,여자,여자,남자,2
2483,말모이,2019-01-09,2019-01-27,18,2384,783,324666,21.3,591831080,22351901163,69004,2657542,2,드라마,롯데컬처웍스(주)롯데엔터테인먼트,여자,여자,남자,2
2484,말모이,2019-01-09,2019-01-28,19,2295,760,317453,7.6,185643950,22537545113,24255,2681797,2,드라마,롯데컬처웍스(주)롯데엔터테인먼트,여자,여자,남자,2
2485,말모이,2019-01-09,2019-01-29,20,2302,783,314370,8.0,188179030,22725724143,25202,2706999,2,드라마,롯데컬처웍스(주)롯데엔터테인먼트,여자,여자,남자,2
2486,말모이,2019-01-09,2019-01-30,21,818,391,98453,21.5,121453510,22847177653,21211,2728210,2,드라마,롯데컬처웍스(주)롯데엔터테인먼트,여자,여자,남자,2
2487,말모이,2019-01-09,2019-01-31,22,688,338,80557,12.3,71817810,22918995463,9897,2738107,2,드라마,롯데컬처웍스(주)롯데엔터테인먼트,여자,여자,남자,2
2488,말모이,2019-01-09,2019-02-01,23,645,318,74333,14.3,83062122,23002057585,10617,2748724,2,드라마,롯데컬처웍스(주)롯데엔터테인먼트,여자,여자,남자,2
2489,말모이,2019-01-09,2019-02-02,24,531,281,61150,26.3,133440445,23135498030,16107,2764831,2,드라마,롯데컬처웍스(주)롯데엔터테인먼트,여자,여자,남자,2
2490,말모이,2019-01-09,2019-02-03,25,525,286,60574,30.9,158192230,23293690260,18715,2783546,2,드라마,롯데컬처웍스(주)롯데엔터테인먼트,여자,여자,남자,2
2491,말모이,2019-01-09,2019-02-04,26,511,281,58860,32.6,164920690,23458610950,19166,2802712,2,드라마,롯데컬처웍스(주)롯데엔터테인먼트,여자,여자,남자,2
2492,말모이,2019-01-09,2019-02-05,27,313,179,36767,39.1,130901580,23589512530,14371,2817083,2,드라마,롯데컬처웍스(주)롯데엔터테인먼트,여자,여자,남자,2
2493,말모이,2019-01-09,2019-02-06,28,286,177,34462,35.5,107285750,23696798280,12231,2829314,2,드라마,롯데컬처웍스(주)롯데엔터테인먼트,여자,여자,남자,2
2494,말모이,2019-01-09,2019-02-07,29,252,147,29909,11.4,26956900,23723755180,3419,2832733,2,드라마,롯데컬처웍스(주)롯데엔터테인먼트,여자,여자,남자,2
2495,말모이,2019-01-09,2019-02-08,30,260,151,32123,12.1,32978800,23756733980,3895,2836628,2,드라마,롯데컬처웍스(주)롯데엔터테인먼트,여자,여자,남자,2
2496,말모이,2019-01-09,2019-02-09,31,291,174,34240,18.9,58823410,23815557390,6466,2843094,2,드라마,롯데컬처웍스(주)롯데엔터테인먼트,여자,여자,남자,2
2497,말모이,2019-01-09,2019-02-10,32,287,175,33783,16.7,51244980,23866802370,5642,2848736,2,드라마,롯데컬처웍스(주)롯데엔터테인먼트,여자,여자,남자,2
2498,말모이,2019-01-09,2019-02-11,33,269,159,32505,8.1,19484750,23886287120,2627,2851363,2,드라마,롯데컬처웍스(주)롯데엔터테인먼트,여자,여자,남자,2
2499,말모이,2019-01-09,2019-02-12,34,264,160,32464,7.9,19106200,23905393320,2550,2853913,2,드라마,롯데컬처웍스(주)롯데엔터테인먼트,여자,여자,남자,2
2500,말모이,2019-01-09,2019-02-13,35,42,30,4542,24.8,7324800,23912718120,1128,2855041,2,드라마,롯데컬처웍스(주)롯데엔터테인먼트,여자,여자,남자,2
2501,말모이,2019-01-09,2019-02-14,36,12,10,1276,25.1,2122100,23914840220,320,2855361,2,드라마,롯데컬처웍스(주)롯데엔터테인먼트,여자,여자,남자,2
2502,말모이,2019-01-09,2019-02-15,37,9,8,1062,20.3,1900300,23916740520,216,2855577,2,드라마,롯데컬처웍스(주)롯데엔터테인먼트,여자,여자,남자,2
2503,말모이,2019-01-09,2019-02-16,38,12,10,1639,24.2,3036900,23919777420,396,2855973,2,드라마,롯데컬처웍스(주)롯데엔터테인먼트,여자,여자,남자,2
2504,말모이,2019-01-09,2019-02-17,39,9,8,1015,17.5,1542800,23921320220,178,2856151,2,드라마,롯데컬처웍스(주)롯데엔터테인먼트,여자,여자,남자,2
2505,말모이,2019-01-09,2019-02-18,40,21,17,2927,12.8,2275600,23923595820,375,2856526,2,드라마,롯데컬처웍스(주)롯데엔터테인먼트,여자,여자,남자,2
2506,말모이,2019-01-09,2019-02-19,41,37,35,4493,23.8,5938600,23929534420,1067,2857593,2,드라마,롯데컬처웍스(주)롯데엔터테인먼트,여자,여자,남자,2
2507,말모이,2019-01-09,2019-02-20,42,9,9,1251,42.1,3779000,23933313420,526,2858119,2,드라마,롯데컬처웍스(주)롯데엔터테인먼트,여자,여자,남자,2
2508,말모이,2019-01-09,2019-02-21,43,34,33,4073,33.6,7217000,23940530420,1369,2859488,2,드라마,롯데컬처웍스(주)롯데엔터테인먼트,여자,여자,남자,2
2509,말모이,2019-01-09,2019-02-22,44,5,5,598,28.9,1044300,23941574720,173,2859661,2,드라마,롯데컬처웍스(주)롯데엔터테인먼트,여자,여자,남자,2
2510,말모이,2019-01-09,2019-02-23,45,10,10,1622,26.6,3030000,23944604720,432,2860093,2,드라마,롯데컬처웍스(주)롯데엔터테인먼트,여자,여자,남자,2
2511,말모이,2019-01-09,2019-02-24,46,5,5,910,64.8,4682000,23949286720,590,2860683,2,드라마,롯데컬처웍스(주)롯데엔터테인먼트,여자,여자,남자,2
2512,말모이,2019-01-09,2019-02-25,47,7,7,972,23.9,1575300,23950862020,232,2860915,2,드라마,롯데컬처웍스(주)롯데엔터테인먼트,여자,여자,남자,2
2513,말모이,2019-01-09,2019-02-26,48,3,3,516,6.2,169500,23951031520,32,2860947,2,드라마,롯데컬처웍스(주)롯데엔터테인먼트,여자,여자,남자,2
2514,말모이,2019-01-09,2019-02-27,49,3,3,197,22.3,220000,23951251520,44,2860991,2,드라마,롯데컬처웍스(주)롯데엔터테인먼트,여자,여자,남자,2
2515,말모이,2019-01-09,2019-03-01,51,2,1,80,61.3,482000,23951733520,49,2861040,2,드라마,롯데컬처웍스(주)롯데엔터테인먼트,여자,여자,남자,2
2516,말모이,2019-01-09,2019-03-03,53,3,3,359,81.3,2628000,23954361520,292,2861332,2,드라마,롯데컬처웍스(주)롯데엔터테인먼트,여자,여자,남자,2
2517,말모이,2019-01-09,2019-03-06,56,1,1,40,2.5,9000,23954370520,1,2861333,2,드라마,롯데컬처웍스(주)롯데엔터테인먼트,여자,여자,남자,2
2518,말모이,2019-01-09,2019-03-10,60,1,1,40,10.0,28000,23954398520,4,2861337,2,드라마,롯데컬처웍스(주)롯데엔터테인먼트,여자,여자,남자,2
2519,말모이,2019-01-09,2019-03-12,62,1,1,40,2.5,9000,23954407520,1,2861338,2,드라마,롯데컬처웍스(주)롯데엔터테인먼트,여자,여자,남자,2
2520,말모이,2019-01-09,2019-03-14,64,1,1,40,40.0,118000,23954525520,16,2861354,2,드라마,롯데컬처웍스(주)롯데엔터테인먼트,여자,여자,남자,2
2521,말모이,2019-01-09,2019-03-15,65,1,1,183,100.0,1181000,23955706520,183,2861537,2,드라마,롯데컬처웍스(주)롯데엔터테인먼트,여자,여자,남자,2
2522,말모이,2019-01-09,2019-03-16,66,2,2,343,100.0,2744000,23958450520,343,2861880,2,드라마,롯데컬처웍스(주)롯데엔터테인먼트,여자,여자,남자,2
2523,말모이,2019-01-09,2019-03-17,67,1,1,40,5.0,20000,23958470520,2,2861882,2,드라마,롯데컬처웍스(주)롯데엔터테인먼트,여자,여자,남자,2
2524,말모이,2019-01-09,2019-03-20,70,5,5,1063,98.2,9092000,23967562520,1044,2862926,2,드라마,롯데컬처웍스(주)롯데엔터테인먼트,여자,여자,남자,2
2525,말모이,2019-01-09,2019-03-22,72,1,1,175,100.0,1225000,23968787520,175,2863101,2,드라마,롯데컬처웍스(주)롯데엔터테인먼트,여자,여자,남자,2
2526,말모이,2019-01-09,2019-03-24,74,1,1,306,100.0,3060000,23971847520,306,2863407,2,드라마,롯데컬처웍스(주)롯데엔터테인먼트,여자,여자,남자,2
2527,말모이,2019-01-09,2019-03-27,77,3,2,586,100.0,3304000,23975151520,586,2863993,2,드라마,롯데컬처웍스(주)롯데엔터테인먼트,여자,여자,남자,2
2528,말모이,2019-01-09,2019-03-30,80,2,2,255,100.0,1530000,23976681520,255,2864248,2,드라마,롯데컬처웍스(주)롯데엔터테인먼트,여자,여자,남자,2
2529,말모이,2019-01-09,2019-04-03,84,1,1,116,86.2,500000,23977181520,100,2864348,2,드라마,롯데컬처웍스(주)롯데엔터테인먼트,여자,여자,남자,2
2530,말모이,2019-01-09,2019-04-13,94,3,1,225,100.0,1500000,23978681520,225,2864573,2,드라마,롯데컬처웍스(주)롯데엔터테인먼트,여자,여자,남자,2
2531,말모이,2019-01-09,2019-04-18,99,1,1,183,100.0,1098000,23979779520,183,2864756,2,드라마,롯데컬처웍스(주)롯데엔터테인먼트,여자,여자,남자,2
2532,말모이,2019-01-09,2019-05-14,125,2,2,299,59.2,1062000,23980841520,177,2864933,2,드라마,롯데컬처웍스(주)롯데엔터테인먼트,여자,여자,남자,2
2533,말모이,2019-01-09,2019-05-23,134,2,2,465,83.9,2220000,23983061520,390,2865323,2,드라마,롯데컬처웍스(주)롯데엔터테인먼트,여자,여자,남자,2
2534,말모이,2019-01-09,2019-06-05,147,1,1,83,72.3,360000,23983421520,60,2865383,2,드라마,롯데컬처웍스(주)롯데엔터테인먼트,여자,여자,남자,2
2535,말모이,2019-01-09,2019-06-11,153,6,6,645,78.0,3018000,23986439520,503,2865886,2,드라마,롯데컬처웍스(주)롯데엔터테인먼트,여자,여자,남자,2
2536,말모이,2019-01-09,2019-07-04,176,1,1,172,57.0,490000,23986929520,98,2865984,2,드라마,롯데컬처웍스(주)롯데엔터테인먼트,여자,여자,남자,2
2537,말모이,2019-01-09,2019-07-10,182,1,1,36,100.0,216000,23987145520,36,2866020,2,드라마,롯데컬처웍스(주)롯데엔터테인먼트,여자,여자,남자,2
2538,말모이,2019-01-09,2019-10-22,286,1,1,316,76.0,1200000,23988345520,240,2866260,2,드라마,롯데컬처웍스(주)롯데엔터테인먼트,여자,여자,남자,2
2539,말모이,2019-01-09,2019-11-01,296,1,1,97,100.0,485000,23988830520,97,2866357,2,드라마,롯데컬처웍스(주)롯데엔터테인먼트,여자,여자,남자,2
2540,말모이,2019-01-09,2019-11-03,298,1,1,96,100.0,768000,23989598520,96,2866453,2,드라마,롯데컬처웍스(주)롯데엔터테인먼트,여자,여자,남자,2
2541,내안의 그놈,2019-01-09,2018-11-28,-42,1,1,132,100.0,1188000,1188000,132,132,0,"판타지,코미디","(주)메리크리스마스,TCO(주)더콘텐츠온",남자,남자,남자,0
2542,내안의 그놈,2019-01-09,2018-11-29,-41,1,1,233,100.0,1398000,2586000,233,365,0,"판타지,코미디","(주)메리크리스마스,TCO(주)더콘텐츠온",남자,남자,남자,0
2543,내안의 그놈,2019-01-09,2018-11-30,-40,7,6,1339,100.0,8034000,10620000,1339,1704,0,"판타지,코미디","(주)메리크리스마스,TCO(주)더콘텐츠온",남자,남자,남자,0
2544,내안의 그놈,2019-01-09,2018-12-01,-39,1,1,134,100.0,938000,11558000,134,1838,0,"판타지,코미디","(주)메리크리스마스,TCO(주)더콘텐츠온",남자,남자,남자,0
2545,내안의 그놈,2019-01-09,2018-12-11,-29,1,1,229,100.0,2073000,13631000,229,2067,0,"판타지,코미디","(주)메리크리스마스,TCO(주)더콘텐츠온",남자,남자,남자,0
2546,내안의 그놈,2019-01-09,2018-12-13,-27,7,7,1628,98.9,14490000,28121000,1610,3677,0,"판타지,코미디","(주)메리크리스마스,TCO(주)더콘텐츠온",남자,남자,남자,0
2547,내안의 그놈,2019-01-09,2018-12-14,-26,6,6,1659,100.0,16187000,44308000,1659,5336,0,"판타지,코미디","(주)메리크리스마스,TCO(주)더콘텐츠온",남자,남자,남자,0
2548,내안의 그놈,2019-01-09,2018-12-17,-23,4,4,635,100.0,5715000,50023000,635,5971,0,"판타지,코미디","(주)메리크리스마스,TCO(주)더콘텐츠온",남자,남자,남자,0
2549,내안의 그놈,2019-01-09,2018-12-18,-22,14,14,3316,98.0,21414000,71437000,3249,9220,0,"판타지,코미디","(주)메리크리스마스,TCO(주)더콘텐츠온",남자,남자,남자,0
2550,내안의 그놈,2019-01-09,2018-12-19,-21,8,7,2132,99.3,12210000,83647000,2118,11338,0,"판타지,코미디","(주)메리크리스마스,TCO(주)더콘텐츠온",남자,남자,남자,0
2551,내안의 그놈,2019-01-09,2018-12-20,-20,1,1,160,100.0,960000,84607000,160,11498,0,"판타지,코미디","(주)메리크리스마스,TCO(주)더콘텐츠온",남자,남자,남자,0
2552,내안의 그놈,2019-01-09,2018-12-21,-19,2,2,737,100.0,7915000,92522000,737,12235,0,"판타지,코미디","(주)메리크리스마스,TCO(주)더콘텐츠온",남자,남자,남자,0
2553,내안의 그놈,2019-01-09,2018-12-24,-16,1,1,233,100.0,2097000,94619000,233,12468,0,"판타지,코미디","(주)메리크리스마스,TCO(주)더콘텐츠온",남자,남자,남자,0
2554,내안의 그놈,2019-01-09,2018-12-26,-14,7,5,968,100.0,8303000,102922000,968,13436,0,"판타지,코미디","(주)메리크리스마스,TCO(주)더콘텐츠온",남자,남자,남자,0
2555,내안의 그놈,2019-01-09,2018-12-27,-13,7,7,1734,100.0,15606000,118528000,1734,15170,0,"판타지,코미디","(주)메리크리스마스,TCO(주)더콘텐츠온",남자,남자,남자,0
2556,내안의 그놈,2019-01-09,2018-12-28,-12,1,1,82,1.2,8000,118536000,1,15171,0,"판타지,코미디","(주)메리크리스마스,TCO(주)더콘텐츠온",남자,남자,남자,0
2557,내안의 그놈,2019-01-09,2019-01-03,-6,26,25,5293,90.8,39013000,157549000,4807,19978,0,"판타지,코미디","(주)메리크리스마스,TCO(주)더콘텐츠온",남자,남자,남자,0
2558,내안의 그놈,2019-01-09,2019-01-04,-5,1,1,416,100.0,4576000,162125000,416,20394,0,"판타지,코미디","(주)메리크리스마스,TCO(주)더콘텐츠온",남자,남자,남자,0
2559,내안의 그놈,2019-01-09,2019-01-07,-2,26,26,4400,48.7,22487400,184612400,2142,22536,0,"판타지,코미디","(주)메리크리스마스,TCO(주)더콘텐츠온",남자,남자,남자,0
2560,내안의 그놈,2019-01-09,2019-01-08,-1,28,28,5282,79.2,36013100,220625500,4183,26719,0,"판타지,코미디","(주)메리크리스마스,TCO(주)더콘텐츠온",남자,남자,남자,0
2561,내안의 그놈,2019-01-09,2019-01-09,0,2576,671,367672,23.2,688757700,909383200,85238,111957,0,"판타지,코미디","(주)메리크리스마스,TCO(주)더콘텐츠온",남자,남자,남자,0
2562,내안의 그놈,2019-01-09,2019-01-10,1,2729,776,393926,22.6,721582750,1630965950,88860,200817,0,"판타지,코미디","(주)메리크리스마스,TCO(주)더콘텐츠온",남자,남자,남자,0
2563,내안의 그놈,2019-01-09,2019-01-11,2,3145,880,459295,24.2,984944378,2615910328,111168,311985,0,"판타지,코미디","(주)메리크리스마스,TCO(주)더콘텐츠온",남자,남자,남자,0
2564,내안의 그놈,2019-01-09,2019-01-12,3,3655,1004,558259,40.1,1982344898,4598255226,223603,535588,0,"판타지,코미디","(주)메리크리스마스,TCO(주)더콘텐츠온",남자,남자,남자,0
2565,내안의 그놈,2019-01-09,2019-01-13,4,3730,1041,575436,39.9,2040427250,6638682476,229792,765380,0,"판타지,코미디","(주)메리크리스마스,TCO(주)더콘텐츠온",남자,남자,남자,0
2566,내안의 그놈,2019-01-09,2019-01-14,5,3794,963,607095,15.8,786887930,7425570406,95878,861258,0,"판타지,코미디","(주)메리크리스마스,TCO(주)더콘텐츠온",남자,남자,남자,0
2567,내안의 그놈,2019-01-09,2019-01-15,6,3908,1004,627017,14.8,759249150,8184819556,92667,953925,0,"판타지,코미디","(주)메리크리스마스,TCO(주)더콘텐츠온",남자,남자,남자,0
2568,내안의 그놈,2019-01-09,2019-01-16,7,3612,954,610297,14.7,725335550,8910155106,89952,1043877,0,"판타지,코미디","(주)메리크리스마스,TCO(주)더콘텐츠온",남자,남자,남자,0
2569,내안의 그놈,2019-01-09,2019-01-17,8,3022,862,495938,15.2,619988700,9530143806,75564,1119441,0,"판타지,코미디","(주)메리크리스마스,TCO(주)더콘텐츠온",남자,남자,남자,0
2570,내안의 그놈,2019-01-09,2019-01-18,9,3279,899,533948,16.9,809182593,10339326399,90405,1209846,0,"판타지,코미디","(주)메리크리스마스,TCO(주)더콘텐츠온",남자,남자,남자,0
2571,내안의 그놈,2019-01-09,2019-01-19,10,3775,992,620104,31.6,1739836358,12079162757,195973,1405819,0,"판타지,코미디","(주)메리크리스마스,TCO(주)더콘텐츠온",남자,남자,남자,0
2572,내안의 그놈,2019-01-09,2019-01-20,11,3743,992,616385,31.0,1701531340,13780694097,191234,1597053,0,"판타지,코미디","(주)메리크리스마스,TCO(주)더콘텐츠온",남자,남자,남자,0
2573,내안의 그놈,2019-01-09,2019-01-21,12,3565,890,585604,12.2,583598470,14364292567,71568,1668621,0,"판타지,코미디","(주)메리크리스마스,TCO(주)더콘텐츠온",남자,남자,남자,0
2574,내안의 그놈,2019-01-09,2019-01-22,13,3567,913,586522,10.6,504196110,14868488677,62309,1730930,0,"판타지,코미디","(주)메리크리스마스,TCO(주)더콘텐츠온",남자,남자,남자,0
2575,내안의 그놈,2019-01-09,2019-01-23,14,2243,656,310078,9.6,239958580,15108447257,29853,1760783,0,"판타지,코미디","(주)메리크리스마스,TCO(주)더콘텐츠온",남자,남자,남자,0
2576,내안의 그놈,2019-01-09,2019-01-24,15,2084,641,287562,7.9,182246460,15290693717,22822,1783605,0,"판타지,코미디","(주)메리크리스마스,TCO(주)더콘텐츠온",남자,남자,남자,0
2577,내안의 그놈,2019-01-09,2019-01-25,16,1976,627,266913,7.8,184765582,15475459299,20908,1804513,0,"판타지,코미디","(주)메리크리스마스,TCO(주)더콘텐츠온",남자,남자,남자,0
2578,내안의 그놈,2019-01-09,2019-01-26,17,1668,617,215705,16.4,310555658,15786014957,35366,1839879,0,"판타지,코미디","(주)메리크리스마스,TCO(주)더콘텐츠온",남자,남자,남자,0
2579,내안의 그놈,2019-01-09,2019-01-27,18,1522,602,194858,16.0,274123080,16060138037,31245,1871124,0,"판타지,코미디","(주)메리크리스마스,TCO(주)더콘텐츠온",남자,남자,남자,0
2580,내안의 그놈,2019-01-09,2019-01-28,19,1603,589,205700,7.0,114697320,16174835357,14309,1885433,0,"판타지,코미디","(주)메리크리스마스,TCO(주)더콘텐츠온",남자,남자,남자,0
2581,내안의 그놈,2019-01-09,2019-01-29,20,1578,570,202894,7.6,122265930,16297101287,15429,1900862,0,"판타지,코미디","(주)메리크리스마스,TCO(주)더콘텐츠온",남자,남자,남자,0
2582,내안의 그놈,2019-01-09,2019-01-30,21,165,117,18463,15.7,17823390,16314924677,2895,1903757,0,"판타지,코미디","(주)메리크리스마스,TCO(주)더콘텐츠온",남자,남자,남자,0
2583,내안의 그놈,2019-01-09,2019-01-31,22,119,81,12317,11.8,10723280,16325647957,1455,1905212,0,"판타지,코미디","(주)메리크리스마스,TCO(주)더콘텐츠온",남자,남자,남자,0
2584,내안의 그놈,2019-01-09,2019-02-01,23,112,81,11910,15.3,13745220,16339393177,1817,1907029,0,"판타지,코미디","(주)메리크리스마스,TCO(주)더콘텐츠온",남자,남자,남자,0
2585,내안의 그놈,2019-01-09,2019-02-02,24,87,61,9262,20.6,14787450,16354180627,1906,1908935,0,"판타지,코미디","(주)메리크리스마스,TCO(주)더콘텐츠온",남자,남자,남자,0
2586,내안의 그놈,2019-01-09,2019-02-03,25,84,60,8617,21.7,14303730,16368484357,1867,1910802,0,"판타지,코미디","(주)메리크리스마스,TCO(주)더콘텐츠온",남자,남자,남자,0
2587,내안의 그놈,2019-01-09,2019-02-04,26,88,64,9120,21.9,15011060,16383495417,1994,1912796,0,"판타지,코미디","(주)메리크리스마스,TCO(주)더콘텐츠온",남자,남자,남자,0
2588,내안의 그놈,2019-01-09,2019-02-05,27,25,19,2389,22.6,4364100,16387859517,539,1913335,0,"판타지,코미디","(주)메리크리스마스,TCO(주)더콘텐츠온",남자,남자,남자,0
2589,내안의 그놈,2019-01-09,2019-02-06,28,19,16,2001,20.8,3406300,16391265817,417,1913752,0,"판타지,코미디","(주)메리크리스마스,TCO(주)더콘텐츠온",남자,남자,남자,0
2590,내안의 그놈,2019-01-09,2019-02-07,29,9,8,828,13.3,865000,16392130817,110,1913862,0,"판타지,코미디","(주)메리크리스마스,TCO(주)더콘텐츠온",남자,남자,남자,0
2591,내안의 그놈,2019-01-09,2019-02-08,30,10,9,1092,10.8,1036400,16393167217,118,1913980,0,"판타지,코미디","(주)메리크리스마스,TCO(주)더콘텐츠온",남자,남자,남자,0
2592,내안의 그놈,2019-01-09,2019-02-09,31,11,10,916,25.7,1913200,16395080417,235,1914215,0,"판타지,코미디","(주)메리크리스마스,TCO(주)더콘텐츠온",남자,남자,남자,0
2593,내안의 그놈,2019-01-09,2019-02-10,32,10,9,830,20.4,1431500,16396511917,169,1914384,0,"판타지,코미디","(주)메리크리스마스,TCO(주)더콘텐츠온",남자,남자,남자,0
2594,내안의 그놈,2019-01-09,2019-02-11,33,8,8,886,8.7,599400,16397111317,77,1914461,0,"판타지,코미디","(주)메리크리스마스,TCO(주)더콘텐츠온",남자,남자,남자,0
2595,내안의 그놈,2019-01-09,2019-02-12,34,9,9,937,12.9,946500,16398057817,121,1914582,0,"판타지,코미디","(주)메리크리스마스,TCO(주)더콘텐츠온",남자,남자,남자,0
2596,내안의 그놈,2019-01-09,2019-02-13,35,5,5,738,55.0,3644650,16401702467,406,1914988,0,"판타지,코미디","(주)메리크리스마스,TCO(주)더콘텐츠온",남자,남자,남자,0
2597,내안의 그놈,2019-01-09,2019-02-14,36,3,3,636,38.2,1975000,16403677467,243,1915231,0,"판타지,코미디","(주)메리크리스마스,TCO(주)더콘텐츠온",남자,남자,남자,0
2598,내안의 그놈,2019-01-09,2019-02-15,37,2,2,418,14.1,301000,16403978467,59,1915290,0,"판타지,코미디","(주)메리크리스마스,TCO(주)더콘텐츠온",남자,남자,남자,0
2599,내안의 그놈,2019-01-09,2019-02-16,38,2,2,378,19.3,444600,16404423067,73,1915363,0,"판타지,코미디","(주)메리크리스마스,TCO(주)더콘텐츠온",남자,남자,남자,0
2600,내안의 그놈,2019-01-09,2019-02-17,39,3,3,507,22.3,620000,16405043067,113,1915476,0,"판타지,코미디","(주)메리크리스마스,TCO(주)더콘텐츠온",남자,남자,남자,0
2601,내안의 그놈,2019-01-09,2019-02-18,40,3,3,509,22.6,604000,16405647067,115,1915591,0,"판타지,코미디","(주)메리크리스마스,TCO(주)더콘텐츠온",남자,남자,남자,0
2602,내안의 그놈,2019-01-09,2019-02-19,41,4,4,606,18.0,569000,16406216067,109,1915700,0,"판타지,코미디","(주)메리크리스마스,TCO(주)더콘텐츠온",남자,남자,남자,0
2603,내안의 그놈,2019-01-09,2019-02-20,42,3,3,433,25.2,567000,16406783067,109,1915809,0,"판타지,코미디","(주)메리크리스마스,TCO(주)더콘텐츠온",남자,남자,남자,0
2604,내안의 그놈,2019-01-09,2019-02-21,43,3,3,390,25.9,505000,16407288067,101,1915910,0,"판타지,코미디","(주)메리크리스마스,TCO(주)더콘텐츠온",남자,남자,남자,0
2605,내안의 그놈,2019-01-09,2019-02-22,44,1,1,173,17.9,185000,16407473067,31,1915941,0,"판타지,코미디","(주)메리크리스마스,TCO(주)더콘텐츠온",남자,남자,남자,0
2606,내안의 그놈,2019-01-09,2019-02-25,47,5,2,945,3.3,95000,16407568067,31,1915972,0,"판타지,코미디","(주)메리크리스마스,TCO(주)더콘텐츠온",남자,남자,남자,0
2607,내안의 그놈,2019-01-09,2019-02-26,48,14,14,1289,36.2,2405500,16409973567,467,1916439,0,"판타지,코미디","(주)메리크리스마스,TCO(주)더콘텐츠온",남자,남자,남자,0
2608,내안의 그놈,2019-01-09,2019-02-27,49,2,2,194,30.9,300000,16410273567,60,1916499,0,"판타지,코미디","(주)메리크리스마스,TCO(주)더콘텐츠온",남자,남자,남자,0
2609,내안의 그놈,2019-01-09,2019-02-28,50,11,11,1332,26.3,1801000,16412074567,350,1916849,0,"판타지,코미디","(주)메리크리스마스,TCO(주)더콘텐츠온",남자,남자,남자,0
2610,내안의 그놈,2019-01-09,2019-03-05,55,1,1,97,1.0,5000,16412079567,1,1916850,0,"판타지,코미디","(주)메리크리스마스,TCO(주)더콘텐츠온",남자,남자,남자,0
2611,내안의 그놈,2019-01-09,2019-03-06,56,1,1,104,1.0,5000,16412084567,1,1916851,0,"판타지,코미디","(주)메리크리스마스,TCO(주)더콘텐츠온",남자,남자,남자,0
2612,내안의 그놈,2019-01-09,2019-03-20,70,1,1,83,4.8,32000,16412116567,4,1916855,0,"판타지,코미디","(주)메리크리스마스,TCO(주)더콘텐츠온",남자,남자,남자,0
2613,내안의 그놈,2019-01-09,2019-07-13,185,1,1,75,100.0,750000,16412866567,75,1916930,0,"판타지,코미디","(주)메리크리스마스,TCO(주)더콘텐츠온",남자,남자,남자,0
2614,내안의 그놈,2019-01-09,2019-09-27,261,1,1,102,100.0,714000,16413580567,102,1917032,0,"판타지,코미디","(주)메리크리스마스,TCO(주)더콘텐츠온",남자,남자,남자,0
2615,내안의 그놈,2019-01-09,2019-10-23,287,1,1,127,100.0,600000,16414180567,127,1917159,0,"판타지,코미디","(주)메리크리스마스,TCO(주)더콘텐츠온",남자,남자,남자,0
2616,내안의 그놈,2019-01-09,2019-10-25,289,1,1,86,100.0,946000,16415126567,86,1917245,0,"판타지,코미디","(주)메리크리스마스,TCO(주)더콘텐츠온",남자,남자,남자,0
2617,내안의 그놈,2019-01-09,2019-10-26,290,1,1,200,100.0,1400000,16416526567,200,1917445,0,"판타지,코미디","(주)메리크리스마스,TCO(주)더콘텐츠온",남자,남자,남자,0
2618,생일,2019-04-03,2019-01-16,-77,1,1,262,100.0,1834000,1834000,262,262,2,드라마,(주)넥스트엔터테인먼트월드(NEW),여자,여자,남자,2
2619,생일,2019-04-03,2019-03-06,-28,2,1,458,75.1,3096000,4930000,344,606,2,드라마,(주)넥스트엔터테인먼트월드(NEW),여자,여자,남자,2
2620,생일,2019-04-03,2019-03-13,-21,1,1,166,100.0,1518000,6448000,166,772,2,드라마,(주)넥스트엔터테인먼트월드(NEW),여자,여자,남자,2
2621,생일,2019-04-03,2019-03-15,-19,1,1,247,100.0,1729000,8177000,247,1019,2,드라마,(주)넥스트엔터테인먼트월드(NEW),여자,여자,남자,2
2622,생일,2019-04-03,2019-03-18,-16,12,12,2862,99.3,25587000,33764000,2843,3862,2,드라마,(주)넥스트엔터테인먼트월드(NEW),여자,여자,남자,2
2623,생일,2019-04-03,2019-03-19,-15,2,2,557,97.1,4869000,38633000,541,4403,2,드라마,(주)넥스트엔터테인먼트월드(NEW),여자,여자,남자,2
2624,생일,2019-04-03,2019-03-20,-14,1,1,290,100.0,2610000,41243000,290,4693,2,드라마,(주)넥스트엔터테인먼트월드(NEW),여자,여자,남자,2
2625,생일,2019-04-03,2019-03-21,-13,9,9,1853,100.0,16677000,57920000,1853,6546,2,드라마,(주)넥스트엔터테인먼트월드(NEW),여자,여자,남자,2
2626,생일,2019-04-03,2019-03-25,-9,2,2,689,98.1,6474000,64394000,676,7222,2,드라마,(주)넥스트엔터테인먼트월드(NEW),여자,여자,남자,2
2627,생일,2019-04-03,2019-03-26,-8,2,2,464,100.0,3594000,67988000,464,7686,2,드라마,(주)넥스트엔터테인먼트월드(NEW),여자,여자,남자,2
2628,생일,2019-04-03,2019-03-27,-7,1,1,218,100.0,1962000,69950000,218,7904,2,드라마,(주)넥스트엔터테인먼트월드(NEW),여자,여자,남자,2
2629,생일,2019-04-03,2019-03-28,-6,11,11,2117,100.0,19147000,89097000,2117,10021,2,드라마,(주)넥스트엔터테인먼트월드(NEW),여자,여자,남자,2
2630,생일,2019-04-03,2019-03-29,-5,1,1,190,100.0,2090000,91187000,190,10211,2,드라마,(주)넥스트엔터테인먼트월드(NEW),여자,여자,남자,2
2631,생일,2019-04-03,2019-03-30,-4,1,1,200,100.0,2000000,93187000,200,10411,2,드라마,(주)넥스트엔터테인먼트월드(NEW),여자,여자,남자,2
2632,생일,2019-04-03,2019-04-03,0,3735,852,586086,7.8,357545220,450732220,45516,55927,2,드라마,(주)넥스트엔터테인먼트월드(NEW),여자,여자,남자,2
2633,생일,2019-04-03,2019-04-04,1,3537,847,551252,7.9,341995800,792728020,43517,99444,2,드라마,(주)넥스트엔터테인먼트월드(NEW),여자,여자,남자,2
2634,생일,2019-04-03,2019-04-05,2,3575,862,557643,10.3,495459368,1288187388,57313,156757,2,드라마,(주)넥스트엔터테인먼트월드(NEW),여자,여자,남자,2
2635,생일,2019-04-03,2019-04-06,3,3652,856,566367,20.0,983277413,2271464801,113329,270086,2,드라마,(주)넥스트엔터테인먼트월드(NEW),여자,여자,남자,2
2636,생일,2019-04-03,2019-04-07,4,3580,856,555895,19.0,915734090,3187198891,105359,375445,2,드라마,(주)넥스트엔터테인먼트월드(NEW),여자,여자,남자,2
2637,생일,2019-04-03,2019-04-08,5,3488,824,537992,7.3,313569830,3500768721,39139,414584,2,드라마,(주)넥스트엔터테인먼트월드(NEW),여자,여자,남자,2
2638,생일,2019-04-03,2019-04-09,6,3546,856,551747,7.3,320784100,3821552821,40232,454816,2,드라마,(주)넥스트엔터테인먼트월드(NEW),여자,여자,남자,2
2639,생일,2019-04-03,2019-04-10,7,3063,791,480188,9.0,340577410,4162130231,43351,498167,2,드라마,(주)넥스트엔터테인먼트월드(NEW),여자,여자,남자,2
2640,생일,2019-04-03,2019-04-11,8,2526,717,408718,8.0,254624830,4416755061,32524,530691,2,드라마,(주)넥스트엔터테인먼트월드(NEW),여자,여자,남자,2
2641,생일,2019-04-03,2019-04-12,9,2751,773,453740,10.3,392160230,4808915291,46922,577613,2,드라마,(주)넥스트엔터테인먼트월드(NEW),여자,여자,남자,2
2642,생일,2019-04-03,2019-04-13,10,3271,862,558940,15.4,740847790,5549763081,86029,663642,2,드라마,(주)넥스트엔터테인먼트월드(NEW),여자,여자,남자,2
2643,생일,2019-04-03,2019-04-14,11,3228,865,552223,17.8,851549350,6401312431,98132,761774,2,드라마,(주)넥스트엔터테인먼트월드(NEW),여자,여자,남자,2
2644,생일,2019-04-03,2019-04-15,12,2951,800,498400,6.0,237271000,6638583431,30109,791883,2,드라마,(주)넥스트엔터테인먼트월드(NEW),여자,여자,남자,2
2645,생일,2019-04-03,2019-04-16,13,3085,827,515140,8.2,327654830,6966238261,42389,834272,2,드라마,(주)넥스트엔터테인먼트월드(NEW),여자,여자,남자,2
2646,생일,2019-04-03,2019-04-17,14,2719,709,466422,7.0,254784140,7221022401,32539,866811,2,드라마,(주)넥스트엔터테인먼트월드(NEW),여자,여자,남자,2
2647,생일,2019-04-03,2019-04-18,15,2496,671,445336,6.5,226770890,7447793291,29015,895826,2,드라마,(주)넥스트엔터테인먼트월드(NEW),여자,여자,남자,2
2648,생일,2019-04-03,2019-04-19,16,2744,727,482166,7.6,307912135,7755705426,36846,932672,2,드라마,(주)넥스트엔터테인먼트월드(NEW),여자,여자,남자,2
2649,생일,2019-04-03,2019-04-20,17,3317,878,598313,11.8,599578994,8355284420,70426,1003098,2,드라마,(주)넥스트엔터테인먼트월드(NEW),여자,여자,남자,2
2650,생일,2019-04-03,2019-04-21,18,3232,855,589966,10.7,539663210,8894947630,63042,1066140,2,드라마,(주)넥스트엔터테인먼트월드(NEW),여자,여자,남자,2
2651,생일,2019-04-03,2019-04-22,19,2836,783,503109,4.4,170648890,9065596520,21995,1088135,2,드라마,(주)넥스트엔터테인먼트월드(NEW),여자,여자,남자,2
2652,생일,2019-04-03,2019-04-23,20,2830,783,497140,4.4,167174950,9232771470,21873,1110008,2,드라마,(주)넥스트엔터테인먼트월드(NEW),여자,여자,남자,2
2653,생일,2019-04-03,2019-04-24,21,883,422,102516,17.2,106838670,9339610140,17660,1127668,2,드라마,(주)넥스트엔터테인먼트월드(NEW),여자,여자,남자,2
2654,생일,2019-04-03,2019-04-25,22,777,423,88919,10.5,72857060,9412467200,9375,1137043,2,드라마,(주)넥스트엔터테인먼트월드(NEW),여자,여자,남자,2
2655,생일,2019-04-03,2019-04-26,23,714,410,80341,14.3,96018680,9508485880,11510,1148553,2,드라마,(주)넥스트엔터테인먼트월드(NEW),여자,여자,남자,2
2656,생일,2019-04-03,2019-04-27,24,471,334,55479,19.4,89871710,9598357590,10758,1159311,2,드라마,(주)넥스트엔터테인먼트월드(NEW),여자,여자,남자,2
2657,생일,2019-04-03,2019-04-28,25,460,345,55602,16.3,74505500,9672863090,9075,1168386,2,드라마,(주)넥스트엔터테인먼트월드(NEW),여자,여자,남자,2
2658,생일,2019-04-03,2019-04-29,26,622,378,71119,8.5,45800990,9718664080,6010,1174396,2,드라마,(주)넥스트엔터테인먼트월드(NEW),여자,여자,남자,2
2659,생일,2019-04-03,2019-04-30,27,649,403,73728,12.2,66250450,9784914530,8977,1183373,2,드라마,(주)넥스트엔터테인먼트월드(NEW),여자,여자,남자,2
2660,생일,2019-04-03,2019-05-01,28,141,102,17031,19.9,23233310,9808147840,3389,1186762,2,드라마,(주)넥스트엔터테인먼트월드(NEW),여자,여자,남자,2
2661,생일,2019-04-03,2019-05-02,29,144,106,17906,6.7,8650280,9816798120,1193,1187955,2,드라마,(주)넥스트엔터테인먼트월드(NEW),여자,여자,남자,2
2662,생일,2019-04-03,2019-05-03,30,135,98,16131,10.2,12455710,9829253830,1651,1189606,2,드라마,(주)넥스트엔터테인먼트월드(NEW),여자,여자,남자,2
2663,생일,2019-04-03,2019-05-04,31,61,46,6985,12.3,6604610,9835858440,857,1190463,2,드라마,(주)넥스트엔터테인먼트월드(NEW),여자,여자,남자,2
2664,생일,2019-04-03,2019-05-05,32,44,36,5335,12.2,5085130,9840943570,650,1191113,2,드라마,(주)넥스트엔터테인먼트월드(NEW),여자,여자,남자,2
2665,생일,2019-04-03,2019-05-06,33,57,44,6782,11.6,6189600,9847133170,788,1191901,2,드라마,(주)넥스트엔터테인먼트월드(NEW),여자,여자,남자,2
2666,생일,2019-04-03,2019-05-07,34,157,114,19202,6.9,8673540,9855806710,1326,1193227,2,드라마,(주)넥스트엔터테인먼트월드(NEW),여자,여자,남자,2
2667,생일,2019-04-03,2019-05-08,35,144,104,17610,3.3,4496980,9860303690,578,1193805,2,드라마,(주)넥스트엔터테인먼트월드(NEW),여자,여자,남자,2
2668,생일,2019-04-03,2019-05-09,36,16,15,2267,13.1,2061000,9862364690,296,1194101,2,드라마,(주)넥스트엔터테인먼트월드(NEW),여자,여자,남자,2
2669,생일,2019-04-03,2019-05-10,37,16,14,2044,9.6,1011000,9863375690,196,1194297,2,드라마,(주)넥스트엔터테인먼트월드(NEW),여자,여자,남자,2
2670,생일,2019-04-03,2019-05-11,38,12,9,1495,6.2,605650,9863981340,93,1194390,2,드라마,(주)넥스트엔터테인먼트월드(NEW),여자,여자,남자,2
2671,생일,2019-04-03,2019-05-12,39,10,8,1402,3.9,446500,9864427840,54,1194444,2,드라마,(주)넥스트엔터테인먼트월드(NEW),여자,여자,남자,2
2672,생일,2019-04-03,2019-05-13,40,10,9,1261,1.6,146000,9864573840,20,1194464,2,드라마,(주)넥스트엔터테인먼트월드(NEW),여자,여자,남자,2
2673,생일,2019-04-03,2019-05-14,41,7,7,979,7.4,379000,9864952840,72,1194536,2,드라마,(주)넥스트엔터테인먼트월드(NEW),여자,여자,남자,2
2674,생일,2019-04-03,2019-05-15,42,14,13,1736,48.9,6449000,9871401840,849,1195385,2,드라마,(주)넥스트엔터테인먼트월드(NEW),여자,여자,남자,2
2675,생일,2019-04-03,2019-05-16,43,6,6,734,24.4,1257000,9872658840,179,1195564,2,드라마,(주)넥스트엔터테인먼트월드(NEW),여자,여자,남자,2
2676,생일,2019-04-03,2019-05-17,44,4,3,588,25.5,757000,9873415840,150,1195714,2,드라마,(주)넥스트엔터테인먼트월드(NEW),여자,여자,남자,2
2677,생일,2019-04-03,2019-05-18,45,3,3,475,0.6,22000,9873437840,3,1195717,2,드라마,(주)넥스트엔터테인먼트월드(NEW),여자,여자,남자,2
2678,생일,2019-04-03,2019-05-19,46,3,3,448,2.2,81000,9873518840,10,1195727,2,드라마,(주)넥스트엔터테인먼트월드(NEW),여자,여자,남자,2
2679,생일,2019-04-03,2019-05-20,47,2,2,309,0.7,14000,9873532840,2,1195729,2,드라마,(주)넥스트엔터테인먼트월드(NEW),여자,여자,남자,2
2680,생일,2019-04-03,2019-05-21,48,3,3,399,1.5,48000,9873580840,6,1195735,2,드라마,(주)넥스트엔터테인먼트월드(NEW),여자,여자,남자,2
2681,생일,2019-04-03,2019-05-22,49,3,3,391,56.8,1415000,9874995840,222,1195957,2,드라마,(주)넥스트엔터테인먼트월드(NEW),여자,여자,남자,2
2682,생일,2019-04-03,2019-05-23,50,1,1,141,100.0,846000,9875841840,141,1196098,2,드라마,(주)넥스트엔터테인먼트월드(NEW),여자,여자,남자,2
2683,생일,2019-04-03,2019-05-24,51,1,1,147,100.0,1176000,9877017840,147,1196245,2,드라마,(주)넥스트엔터테인먼트월드(NEW),여자,여자,남자,2
2684,생일,2019-04-03,2019-05-25,52,2,2,362,77.6,1647000,9878664840,281,1196526,2,드라마,(주)넥스트엔터테인먼트월드(NEW),여자,여자,남자,2
2685,생일,2019-04-03,2019-05-26,53,1,1,134,96.3,903000,9879567840,129,1196655,2,드라마,(주)넥스트엔터테인먼트월드(NEW),여자,여자,남자,2
2686,생일,2019-04-03,2019-05-27,54,1,1,117,0.9,5000,9879572840,1,1196656,2,드라마,(주)넥스트엔터테인먼트월드(NEW),여자,여자,남자,2
2687,생일,2019-04-03,2019-05-28,55,1,1,117,0.9,5000,9879577840,1,1196657,2,드라마,(주)넥스트엔터테인먼트월드(NEW),여자,여자,남자,2
2688,생일,2019-04-03,2019-05-30,57,1,1,104,1.0,5000,9879582840,1,1196658,2,드라마,(주)넥스트엔터테인먼트월드(NEW),여자,여자,남자,2
2689,생일,2019-04-03,2019-05-31,58,1,1,117,0.9,5000,9879587840,1,1196659,2,드라마,(주)넥스트엔터테인먼트월드(NEW),여자,여자,남자,2
2690,생일,2019-04-03,2019-06-14,72,1,1,57,61.4,175000,9879762840,35,1196694,2,드라마,(주)넥스트엔터테인먼트월드(NEW),여자,여자,남자,2
2691,생일,2019-04-03,2019-07-15,103,2,2,299,75.9,1362000,9881124840,227,1196921,2,드라마,(주)넥스트엔터테인먼트월드(NEW),여자,여자,남자,2
2692,생일,2019-04-03,2019-07-18,106,1,1,164,48.8,400000,9881524840,80,1197001,2,드라마,(주)넥스트엔터테인먼트월드(NEW),여자,여자,남자,2
2693,생일,2019-04-03,2019-07-20,108,1,1,160,93.8,1050000,9882574840,150,1197151,2,드라마,(주)넥스트엔터테인먼트월드(NEW),여자,여자,남자,2
2694,생일,2019-04-03,2019-08-16,135,2,2,273,100.0,1911000,9884485840,273,1197424,2,드라마,(주)넥스트엔터테인먼트월드(NEW),여자,여자,남자,2
2695,증인,2019-02-13,2019-01-20,-24,1,1,262,100.0,2096000,2096000,262,262,0,드라마,롯데컬처웍스(주)롯데엔터테인먼트,남자,남자,남자,0
2696,증인,2019-02-13,2019-01-21,-23,7,4,966,100.0,8694000,10790000,966,1228,0,드라마,롯데컬처웍스(주)롯데엔터테인먼트,남자,남자,남자,0
2697,증인,2019-02-13,2019-01-22,-22,7,7,1764,93.5,14841000,25631000,1649,2877,0,드라마,롯데컬처웍스(주)롯데엔터테인먼트,남자,남자,남자,0
2698,증인,2019-02-13,2019-01-23,-21,4,4,1022,100.0,9198000,34829000,1022,3899,0,드라마,롯데컬처웍스(주)롯데엔터테인먼트,남자,남자,남자,0
2699,증인,2019-02-13,2019-01-24,-20,4,4,1035,100.0,9315000,44144000,1035,4934,0,드라마,롯데컬처웍스(주)롯데엔터테인먼트,남자,남자,남자,0
2700,증인,2019-02-13,2019-01-28,-16,20,20,5046,99.6,45252000,89396000,5028,9962,0,드라마,롯데컬처웍스(주)롯데엔터테인먼트,남자,남자,남자,0
2701,증인,2019-02-13,2019-01-29,-15,10,10,1996,100.0,17709000,107105000,1996,11958,0,드라마,롯데컬처웍스(주)롯데엔터테인먼트,남자,남자,남자,0
2702,증인,2019-02-13,2019-01-31,-13,46,46,8323,72.0,57808400,164913400,5989,17947,0,드라마,롯데컬처웍스(주)롯데엔터테인먼트,남자,남자,남자,0
2703,증인,2019-02-13,2019-02-01,-12,1,1,450,70.0,3375000,168288400,315,18262,0,드라마,롯데컬처웍스(주)롯데엔터테인먼트,남자,남자,남자,0
2704,증인,2019-02-13,2019-02-02,-11,18,14,5167,64.5,31868480,200156880,3335,21597,0,드라마,롯데컬처웍스(주)롯데엔터테인먼트,남자,남자,남자,0
2705,증인,2019-02-13,2019-02-03,-10,17,14,4025,70.7,27015000,227171880,2846,24443,0,드라마,롯데컬처웍스(주)롯데엔터테인먼트,남자,남자,남자,0
2706,증인,2019-02-13,2019-02-07,-6,12,10,2688,98.2,23760000,250931880,2640,27083,0,드라마,롯데컬처웍스(주)롯데엔터테인먼트,남자,남자,남자,0
2707,증인,2019-02-13,2019-02-09,-4,16,15,4324,82.9,32589580,283521460,3585,30668,0,드라마,롯데컬처웍스(주)롯데엔터테인먼트,남자,남자,남자,0
2708,증인,2019-02-13,2019-02-10,-3,15,14,3474,89.1,29580200,313101660,3095,33763,0,드라마,롯데컬처웍스(주)롯데엔터테인먼트,남자,남자,남자,0
2709,증인,2019-02-13,2019-02-12,-1,25,25,3752,60.3,17590600,330692260,2262,36025,0,드라마,롯데컬처웍스(주)롯데엔터테인먼트,남자,남자,남자,0
2710,증인,2019-02-13,2019-02-13,0,3833,884,614520,13.3,633381650,964073910,81424,117449,0,드라마,롯데컬처웍스(주)롯데엔터테인먼트,남자,남자,남자,0
2711,증인,2019-02-13,2019-02-14,1,3339,806,544844,15.8,669567010,1633640920,85900,203349,0,드라마,롯데컬처웍스(주)롯데엔터테인먼트,남자,남자,남자,0
2712,증인,2019-02-13,2019-02-15,2,3477,833,564813,17.5,833499448,2467140368,98609,301958,0,드라마,롯데컬처웍스(주)롯데엔터테인먼트,남자,남자,남자,0
2713,증인,2019-02-13,2019-02-16,3,3710,937,590524,35.5,1778792893,4245933261,209875,511833,0,드라마,롯데컬처웍스(주)롯데엔터테인먼트,남자,남자,남자,0
2714,증인,2019-02-13,2019-02-17,4,3788,993,601949,37.4,1916911640,6162844901,225305,737138,0,드라마,롯데컬처웍스(주)롯데엔터테인먼트,남자,남자,남자,0
2715,증인,2019-02-13,2019-02-18,5,3822,960,608438,15.5,740659570,6903504471,94251,831389,0,드라마,롯데컬처웍스(주)롯데엔터테인먼트,남자,남자,남자,0
2716,증인,2019-02-13,2019-02-19,6,3981,1047,639282,18.2,808166340,7711670811,116432,947821,0,드라마,롯데컬처웍스(주)롯데엔터테인먼트,남자,남자,남자,0
2717,증인,2019-02-13,2019-02-20,7,3097,830,454827,17.8,623382450,8335053261,80798,1028619,0,드라마,롯데컬처웍스(주)롯데엔터테인먼트,남자,남자,남자,0
2718,증인,2019-02-13,2019-02-21,8,3142,838,467519,16.6,599461310,8934514571,77606,1106225,0,드라마,롯데컬처웍스(주)롯데엔터테인먼트,남자,남자,남자,0
2719,증인,2019-02-13,2019-02-22,9,3447,916,516548,17.5,754247650,9688762221,90479,1196704,0,드라마,롯데컬처웍스(주)롯데엔터테인먼트,남자,남자,남자,0
2720,증인,2019-02-13,2019-02-23,10,4008,1046,605660,31.0,1578803550,11267565771,187720,1384424,0,드라마,롯데컬처웍스(주)롯데엔터테인먼트,남자,남자,남자,0
2721,증인,2019-02-13,2019-02-24,11,3907,1040,597475,29.4,1483881540,12751447311,175832,1560256,0,드라마,롯데컬처웍스(주)롯데엔터테인먼트,남자,남자,남자,0
2722,증인,2019-02-13,2019-02-25,12,3741,943,576863,11.7,523073950,13274521261,67363,1627619,0,드라마,롯데컬처웍스(주)롯데엔터테인먼트,남자,남자,남자,0
2723,증인,2019-02-13,2019-02-26,13,3739,953,578023,11.8,521417400,13795938661,67934,1695553,0,드라마,롯데컬처웍스(주)롯데엔터테인먼트,남자,남자,남자,0
2724,증인,2019-02-13,2019-02-27,14,2909,815,491994,28.2,797764350,14593703011,138913,1834466,0,드라마,롯데컬처웍스(주)롯데엔터테인먼트,남자,남자,남자,0
2725,증인,2019-02-13,2019-02-28,15,3117,850,524384,15.5,621291850,15214994861,81279,1915745,0,드라마,롯데컬처웍스(주)롯데엔터테인먼트,남자,남자,남자,0
2726,증인,2019-02-13,2019-03-01,16,3446,963,567018,26.1,1272099600,16487094461,148186,2063931,0,드라마,롯데컬처웍스(주)롯데엔터테인먼트,남자,남자,남자,0
2727,증인,2019-02-13,2019-03-02,17,3449,974,574511,22.2,1108468290,17595562751,127417,2191348,0,드라마,롯데컬처웍스(주)롯데엔터테인먼트,남자,남자,남자,0
2728,증인,2019-02-13,2019-03-03,18,3355,957,558901,17.4,844511080,18440073831,97042,2288390,0,드라마,롯데컬처웍스(주)롯데엔터테인먼트,남자,남자,남자,0
2729,증인,2019-02-13,2019-03-04,19,3005,843,500020,5.5,219982460,18660056291,27595,2315985,0,드라마,롯데컬처웍스(주)롯데엔터테인먼트,남자,남자,남자,0
2730,증인,2019-02-13,2019-03-05,20,2945,826,488713,5.0,194195930,18854252221,24411,2340396,0,드라마,롯데컬처웍스(주)롯데엔터테인먼트,남자,남자,남자,0
2731,증인,2019-02-13,2019-03-06,21,1607,560,190754,7.9,120170330,18974422551,15115,2355511,0,드라마,롯데컬처웍스(주)롯데엔터테인먼트,남자,남자,남자,0
2732,증인,2019-02-13,2019-03-07,22,1538,556,183019,7.7,112647440,19087069991,14173,2369684,0,드라마,롯데컬처웍스(주)롯데엔터테인먼트,남자,남자,남자,0
2733,증인,2019-02-13,2019-03-08,23,1528,564,183790,8.8,142223710,19229293701,16076,2385760,0,드라마,롯데컬처웍스(주)롯데엔터테인먼트,남자,남자,남자,0
2734,증인,2019-02-13,2019-03-09,24,1420,555,168324,21.3,316917960,19546211661,35898,2421658,0,드라마,롯데컬처웍스(주)롯데엔터테인먼트,남자,남자,남자,0
2735,증인,2019-02-13,2019-03-10,25,1412,573,168806,21.1,313047340,19859259001,35633,2457291,0,드라마,롯데컬처웍스(주)롯데엔터테인먼트,남자,남자,남자,0
2736,증인,2019-02-13,2019-03-11,26,1420,528,170858,6.3,84851170,19944110171,10735,2468026,0,드라마,롯데컬처웍스(주)롯데엔터테인먼트,남자,남자,남자,0
2737,증인,2019-02-13,2019-03-12,27,1385,536,165471,6.4,82795810,20026905981,10600,2478626,0,드라마,롯데컬처웍스(주)롯데엔터테인먼트,남자,남자,남자,0
2738,증인,2019-02-13,2019-03-13,28,1184,527,142950,6.1,68515820,20095421801,8705,2487331,0,드라마,롯데컬처웍스(주)롯데엔터테인먼트,남자,남자,남자,0
2739,증인,2019-02-13,2019-03-14,29,656,371,78500,6.7,40310990,20135732791,5294,2492625,0,드라마,롯데컬처웍스(주)롯데엔터테인먼트,남자,남자,남자,0
2740,증인,2019-02-13,2019-03-15,30,683,368,81426,7.3,51260690,20186993481,5926,2498551,0,드라마,롯데컬처웍스(주)롯데엔터테인먼트,남자,남자,남자,0
2741,증인,2019-02-13,2019-03-16,31,643,379,76779,14.6,97622220,20284615701,11229,2509780,0,드라마,롯데컬처웍스(주)롯데엔터테인먼트,남자,남자,남자,0
2742,증인,2019-02-13,2019-03-17,32,620,369,74354,12.6,81054020,20365669721,9370,2519150,0,드라마,롯데컬처웍스(주)롯데엔터테인먼트,남자,남자,남자,0
2743,증인,2019-02-13,2019-03-18,33,657,373,78086,5.1,30810100,20396479821,3996,2523146,0,드라마,롯데컬처웍스(주)롯데엔터테인먼트,남자,남자,남자,0
2744,증인,2019-02-13,2019-03-19,34,650,367,76235,5.4,30369050,20426848871,4121,2527267,0,드라마,롯데컬처웍스(주)롯데엔터테인먼트,남자,남자,남자,0
2745,증인,2019-02-13,2019-03-20,35,80,68,9839,8.2,6799300,20433648171,810,2528077,0,드라마,롯데컬처웍스(주)롯데엔터테인먼트,남자,남자,남자,0
2746,증인,2019-02-13,2019-03-21,36,79,63,9692,7.5,4711500,20438359671,722,2528799,0,드라마,롯데컬처웍스(주)롯데엔터테인먼트,남자,남자,남자,0
2747,증인,2019-02-13,2019-03-22,37,73,62,9041,7.9,5133450,20443493121,717,2529516,0,드라마,롯데컬처웍스(주)롯데엔터테인먼트,남자,남자,남자,0
2748,증인,2019-02-13,2019-03-23,38,69,62,7792,10.0,6212380,20449705501,779,2530295,0,드라마,롯데컬처웍스(주)롯데엔터테인먼트,남자,남자,남자,0
2749,증인,2019-02-13,2019-03-24,39,65,60,7724,9.8,6623030,20456328531,760,2531055,0,드라마,롯데컬처웍스(주)롯데엔터테인먼트,남자,남자,남자,0
2750,증인,2019-02-13,2019-03-25,40,66,51,7810,5.3,2750100,20459078631,417,2531472,0,드라마,롯데컬처웍스(주)롯데엔터테인먼트,남자,남자,남자,0
2751,증인,2019-02-13,2019-03-26,41,66,56,7950,6.0,3359800,20462438431,475,2531947,0,드라마,롯데컬처웍스(주)롯데엔터테인먼트,남자,남자,남자,0
2752,증인,2019-02-13,2019-03-27,42,6,6,871,11.3,758000,20463196431,98,2532045,0,드라마,롯데컬처웍스(주)롯데엔터테인먼트,남자,남자,남자,0
2753,증인,2019-02-13,2019-03-28,43,6,6,886,38.2,2657200,20465853631,338,2532383,0,드라마,롯데컬처웍스(주)롯데엔터테인먼트,남자,남자,남자,0
2754,증인,2019-02-13,2019-03-29,44,5,5,683,23.3,1214500,20467068131,159,2532542,0,드라마,롯데컬처웍스(주)롯데엔터테인먼트,남자,남자,남자,0
2755,증인,2019-02-13,2019-03-30,45,4,4,545,21.5,1051800,20468119931,117,2532659,0,드라마,롯데컬처웍스(주)롯데엔터테인먼트,남자,남자,남자,0
2756,증인,2019-02-13,2019-03-31,46,5,5,719,29.9,1879100,20469999031,215,2532874,0,드라마,롯데컬처웍스(주)롯데엔터테인먼트,남자,남자,남자,0
2757,증인,2019-02-13,2019-04-01,47,5,5,695,11.2,655000,20470654031,78,2532952,0,드라마,롯데컬처웍스(주)롯데엔터테인먼트,남자,남자,남자,0
2758,증인,2019-02-13,2019-04-02,48,2,2,286,3.2,73000,20470727031,9,2532961,0,드라마,롯데컬처웍스(주)롯데엔터테인먼트,남자,남자,남자,0
2759,증인,2019-02-13,2019-04-04,50,1,1,153,0.7,6000,20470733031,1,2532962,0,드라마,롯데컬처웍스(주)롯데엔터테인먼트,남자,남자,남자,0
2760,증인,2019-02-13,2019-04-11,57,2,2,560,66.4,1860000,20472593031,372,2533334,0,드라마,롯데컬처웍스(주)롯데엔터테인먼트,남자,남자,남자,0
2761,증인,2019-02-13,2019-04-16,62,1,1,105,86.7,546000,20473139031,91,2533425,0,드라마,롯데컬처웍스(주)롯데엔터테인먼트,남자,남자,남자,0
2762,증인,2019-02-13,2019-04-18,64,1,1,153,65.4,600000,20473739031,100,2533525,0,드라마,롯데컬처웍스(주)롯데엔터테인먼트,남자,남자,남자,0
2763,증인,2019-02-13,2019-04-30,76,1,1,32,100.0,192000,20473931031,32,2533557,0,드라마,롯데컬처웍스(주)롯데엔터테인먼트,남자,남자,남자,0
2764,증인,2019-02-13,2019-05-08,84,23,22,3080,2.3,454300,20474385331,71,2533628,0,드라마,롯데컬처웍스(주)롯데엔터테인먼트,남자,남자,남자,0
2765,증인,2019-02-13,2019-05-09,85,27,26,3727,1.9,433800,20474819131,71,2533699,0,드라마,롯데컬처웍스(주)롯데엔터테인먼트,남자,남자,남자,0
2766,증인,2019-02-13,2019-05-10,86,24,24,3269,2.3,484300,20475303431,74,2533773,0,드라마,롯데컬처웍스(주)롯데엔터테인먼트,남자,남자,남자,0
2767,증인,2019-02-13,2019-05-11,87,19,19,2229,2.2,331900,20475635331,50,2533823,0,드라마,롯데컬처웍스(주)롯데엔터테인먼트,남자,남자,남자,0
2768,증인,2019-02-13,2019-05-12,88,22,22,2587,5.1,854900,20476490231,132,2533955,0,드라마,롯데컬처웍스(주)롯데엔터테인먼트,남자,남자,남자,0
2769,증인,2019-02-13,2019-05-13,89,23,23,2973,2.4,462800,20476953031,72,2534027,0,드라마,롯데컬처웍스(주)롯데엔터테인먼트,남자,남자,남자,0
2770,증인,2019-02-13,2019-05-14,90,18,18,2193,2.2,309300,20477262331,48,2534075,0,드라마,롯데컬처웍스(주)롯데엔터테인먼트,남자,남자,남자,0
2771,증인,2019-02-13,2019-08-22,190,1,1,209,47.9,600000,20477862331,100,2534175,0,드라마,롯데컬처웍스(주)롯데엔터테인먼트,남자,남자,남자,0
2772,증인,2019-02-13,2019-11-05,265,1,1,87,59.8,264000,20478126331,52,2534227,0,드라마,롯데컬처웍스(주)롯데엔터테인먼트,남자,남자,남자,0
2773,증인,2019-02-13,2019-11-06,266,1,1,106,98.1,700000,20478826331,104,2534331,0,드라마,롯데컬처웍스(주)롯데엔터테인먼트,남자,남자,남자,0
2774,사바하,2019-02-20,2019-01-29,-22,3,2,842,86.3,5325000,5325000,727,727,0,"미스터리,스릴러",씨제이이앤엠(주),남자,남자,남자,0
2775,사바하,2019-02-20,2019-02-13,-7,6,5,1651,86.7,12888000,18213000,1432,2159,0,"미스터리,스릴러",씨제이이앤엠(주),남자,남자,남자,0
2776,사바하,2019-02-20,2019-02-18,-2,9,9,1816,100.0,16344000,34557000,1816,3975,0,"미스터리,스릴러",씨제이이앤엠(주),남자,남자,남자,0
2777,사바하,2019-02-20,2019-02-19,-1,23,23,4658,68.7,34745100,69302100,3198,7173,0,"미스터리,스릴러",씨제이이앤엠(주),남자,남자,남자,0
2778,사바하,2019-02-20,2019-02-20,0,5881,1162,1102873,16.7,1438049010,1507351110,184517,191690,0,"미스터리,스릴러",씨제이이앤엠(주),남자,남자,남자,0
2779,사바하,2019-02-20,2019-02-21,1,5725,1149,1074884,13.5,1165412830,2672763940,144986,336676,0,"미스터리,스릴러",씨제이이앤엠(주),남자,남자,남자,0
2780,사바하,2019-02-20,2019-02-22,2,5771,1174,1085171,16.3,1540198127,4212962067,177329,514005,0,"미스터리,스릴러",씨제이이앤엠(주),남자,남자,남자,0
2781,사바하,2019-02-20,2019-02-23,3,5685,1142,1075214,32.4,3045293226,7258255293,348834,862839,0,"미스터리,스릴러",씨제이이앤엠(주),남자,남자,남자,0
2782,사바하,2019-02-20,2019-02-24,4,5576,1155,1049943,29.8,2737714320,9995969613,313336,1176175,0,"미스터리,스릴러",씨제이이앤엠(주),남자,남자,남자,0
2783,사바하,2019-02-20,2019-02-25,5,5320,1080,996249,12.0,965961820,10961931433,119778,1295953,0,"미스터리,스릴러",씨제이이앤엠(주),남자,남자,남자,0
2784,사바하,2019-02-20,2019-02-26,6,5281,1103,987829,10.8,854748280,11816679713,106800,1402753,0,"미스터리,스릴러",씨제이이앤엠(주),남자,남자,남자,0
2785,사바하,2019-02-20,2019-02-27,7,3693,906,722156,23.2,994175600,12810855313,167791,1570544,0,"미스터리,스릴러",씨제이이앤엠(주),남자,남자,남자,0
2786,사바하,2019-02-20,2019-02-28,8,3798,909,742813,14.4,848706180,13659561493,106839,1677383,0,"미스터리,스릴러",씨제이이앤엠(주),남자,남자,남자,0
2787,사바하,2019-02-20,2019-03-01,9,3907,949,746995,25.0,1654706831,15314268324,186751,1864134,0,"미스터리,스릴러",씨제이이앤엠(주),남자,남자,남자,0
2788,사바하,2019-02-20,2019-03-02,10,3780,955,708756,22.9,1448025360,16762293684,162038,2026172,0,"미스터리,스릴러",씨제이이앤엠(주),남자,남자,남자,0
2789,사바하,2019-02-20,2019-03-03,11,3626,912,678802,18.0,1093715450,17856009134,122329,2148501,0,"미스터리,스릴러",씨제이이앤엠(주),남자,남자,남자,0
2790,사바하,2019-02-20,2019-03-04,12,3339,832,607875,6.1,306001570,18162010704,37179,2185680,0,"미스터리,스릴러",씨제이이앤엠(주),남자,남자,남자,0
2791,사바하,2019-02-20,2019-03-05,13,3315,833,605536,5.6,275004010,18437014714,33650,2219330,0,"미스터리,스릴러",씨제이이앤엠(주),남자,남자,남자,0
2792,사바하,2019-02-20,2019-03-06,14,1444,524,182953,8.7,132256680,18569271394,15911,2235241,0,"미스터리,스릴러",씨제이이앤엠(주),남자,남자,남자,0
2793,사바하,2019-02-20,2019-03-07,15,1360,518,172354,8.4,120676810,18689948204,14538,2249779,0,"미스터리,스릴러",씨제이이앤엠(주),남자,남자,남자,0
2794,사바하,2019-02-20,2019-03-08,16,1401,553,177663,10.6,173703940,18863652144,18892,2268671,0,"미스터리,스릴러",씨제이이앤엠(주),남자,남자,남자,0
2795,사바하,2019-02-20,2019-03-09,17,1315,560,164018,23.4,351574340,19215226484,38446,2307117,0,"미스터리,스릴러",씨제이이앤엠(주),남자,남자,남자,0
2796,사바하,2019-02-20,2019-03-10,18,1285,546,159443,21.0,305089580,19520316064,33408,2340525,0,"미스터리,스릴러",씨제이이앤엠(주),남자,남자,남자,0
2797,사바하,2019-02-20,2019-03-11,19,1295,527,162542,6.6,89664810,19609980874,10706,2351231,0,"미스터리,스릴러",씨제이이앤엠(주),남자,남자,남자,0
2798,사바하,2019-02-20,2019-03-12,20,1295,544,162249,6.2,83034020,19693014894,9976,2361207,0,"미스터리,스릴러",씨제이이앤엠(주),남자,남자,남자,0
2799,사바하,2019-02-20,2019-03-13,21,1087,504,136170,5.9,66747100,19759761994,8076,2369283,0,"미스터리,스릴러",씨제이이앤엠(주),남자,남자,남자,0
2800,사바하,2019-02-20,2019-03-14,22,439,271,52172,6.7,28952640,19788714634,3503,2372786,0,"미스터리,스릴러",씨제이이앤엠(주),남자,남자,남자,0
2801,사바하,2019-02-20,2019-03-15,23,462,277,54915,7.3,36463140,19825177774,3997,2376783,0,"미스터리,스릴러",씨제이이앤엠(주),남자,남자,남자,0
2802,사바하,2019-02-20,2019-03-16,24,431,289,48796,15.8,69733480,19894911254,7730,2384513,0,"미스터리,스릴러",씨제이이앤엠(주),남자,남자,남자,0
2803,사바하,2019-02-20,2019-03-17,25,413,271,46425,11.3,47116780,19942028034,5247,2389760,0,"미스터리,스릴러",씨제이이앤엠(주),남자,남자,남자,0
2804,사바하,2019-02-20,2019-03-18,26,439,279,51149,4.7,19580110,19961608144,2376,2392136,0,"미스터리,스릴러",씨제이이앤엠(주),남자,남자,남자,0
2805,사바하,2019-02-20,2019-03-19,27,427,272,50722,4.2,17355270,19978963414,2149,2394285,0,"미스터리,스릴러",씨제이이앤엠(주),남자,남자,남자,0
2806,사바하,2019-02-20,2019-03-20,28,22,20,2759,9.7,1746800,19980710214,267,2394552,0,"미스터리,스릴러",씨제이이앤엠(주),남자,남자,남자,0
2807,사바하,2019-02-20,2019-03-21,29,20,19,3117,23.8,6059950,19986770164,741,2395293,0,"미스터리,스릴러",씨제이이앤엠(주),남자,남자,남자,0
2808,사바하,2019-02-20,2019-03-22,30,18,17,2416,10.8,1713850,19988484014,261,2395554,0,"미스터리,스릴러",씨제이이앤엠(주),남자,남자,남자,0
2809,사바하,2019-02-20,2019-03-23,31,19,17,2736,12.1,2393000,19990877014,331,2395885,0,"미스터리,스릴러",씨제이이앤엠(주),남자,남자,남자,0
2810,사바하,2019-02-20,2019-03-24,32,16,16,2312,11.9,1907480,19992784494,274,2396159,0,"미스터리,스릴러",씨제이이앤엠(주),남자,남자,남자,0
2811,사바하,2019-02-20,2019-03-25,33,18,17,2341,8.4,1319300,19994103794,197,2396356,0,"미스터리,스릴러",씨제이이앤엠(주),남자,남자,남자,0
2812,사바하,2019-02-20,2019-03-26,34,19,19,2813,7.2,1389800,19995493594,202,2396558,0,"미스터리,스릴러",씨제이이앤엠(주),남자,남자,남자,0
2813,사바하,2019-02-20,2019-03-27,35,31,30,4109,8.8,2326400,19997819994,363,2396921,0,"미스터리,스릴러",씨제이이앤엠(주),남자,남자,남자,0
2814,사바하,2019-02-20,2019-03-28,36,12,12,1799,9.1,1050500,19998870494,164,2397085,0,"미스터리,스릴러",씨제이이앤엠(주),남자,남자,남자,0
2815,사바하,2019-02-20,2019-03-29,37,11,11,1961,8.1,1050500,19999920994,159,2397244,0,"미스터리,스릴러",씨제이이앤엠(주),남자,남자,남자,0
2816,사바하,2019-02-20,2019-03-30,38,10,10,1569,12.4,1416300,20001337294,194,2397438,0,"미스터리,스릴러",씨제이이앤엠(주),남자,남자,남자,0
2817,사바하,2019-02-20,2019-03-31,39,10,10,1782,9.2,1104600,20002441894,163,2397601,0,"미스터리,스릴러",씨제이이앤엠(주),남자,남자,남자,0
2818,사바하,2019-02-20,2019-04-01,40,10,10,1526,9.8,954000,20003395894,149,2397750,0,"미스터리,스릴러",씨제이이앤엠(주),남자,남자,남자,0
2819,사바하,2019-02-20,2019-04-02,41,10,10,1484,10.7,1032300,20004428194,158,2397908,0,"미스터리,스릴러",씨제이이앤엠(주),남자,남자,남자,0
2820,사바하,2019-02-20,2019-04-03,42,5,5,662,13.6,450000,20004878194,90,2397998,0,"미스터리,스릴러",씨제이이앤엠(주),남자,남자,남자,0
2821,사바하,2019-02-20,2019-04-04,43,6,6,766,12.4,495000,20005373194,95,2398093,0,"미스터리,스릴러",씨제이이앤엠(주),남자,남자,남자,0
2822,사바하,2019-02-20,2019-04-05,44,5,5,710,12.0,425000,20005798194,85,2398178,0,"미스터리,스릴러",씨제이이앤엠(주),남자,남자,남자,0
2823,사바하,2019-02-20,2019-04-06,45,5,5,808,10.5,425000,20006223194,85,2398263,0,"미스터리,스릴러",씨제이이앤엠(주),남자,남자,남자,0
2824,사바하,2019-02-20,2019-04-07,46,5,5,808,10.5,425000,20006648194,85,2398348,0,"미스터리,스릴러",씨제이이앤엠(주),남자,남자,남자,0
2825,사바하,2019-02-20,2019-04-08,47,5,5,770,11.0,425000,20007073194,85,2398433,0,"미스터리,스릴러",씨제이이앤엠(주),남자,남자,남자,0
2826,사바하,2019-02-20,2019-04-09,48,5,5,790,10.8,425000,20007498194,85,2398518,0,"미스터리,스릴러",씨제이이앤엠(주),남자,남자,남자,0
2827,사바하,2019-02-20,2019-04-23,62,1,1,203,0.5,10000,20007508194,1,2398519,0,"미스터리,스릴러",씨제이이앤엠(주),남자,남자,남자,0
2828,변신,2019-08-21,2019-08-08,-13,1,1,348,100.0,3132000,3132000,348,348,1,"공포(호러),스릴러",(주)에이스메이커무비웍스,남자,여자,남자,1
2829,변신,2019-08-21,2019-08-09,-12,1,1,96,100.0,864000,3996000,96,444,1,"공포(호러),스릴러",(주)에이스메이커무비웍스,남자,여자,남자,1
2830,변신,2019-08-21,2019-08-12,-9,33,30,7604,97.2,65367000,69363000,7392,7836,1,"공포(호러),스릴러",(주)에이스메이커무비웍스,남자,여자,남자,1
2831,변신,2019-08-21,2019-08-13,-8,32,32,6446,100.1,56892000,126255000,6453,14289,1,"공포(호러),스릴러",(주)에이스메이커무비웍스,남자,여자,남자,1
2832,변신,2019-08-21,2019-08-20,-1,1,1,450,69.8,3096500,129351500,314,14603,1,"공포(호러),스릴러",(주)에이스메이커무비웍스,남자,여자,남자,1
2833,변신,2019-08-21,2019-08-21,0,3089,742,418441,23.2,817343910,946695410,97117,111720,1,"공포(호러),스릴러",(주)에이스메이커무비웍스,남자,여자,남자,1
2834,변신,2019-08-21,2019-08-22,1,2877,726,391592,21.8,720853810,1667549220,85377,197097,1,"공포(호러),스릴러",(주)에이스메이커무비웍스,남자,여자,남자,1
2835,변신,2019-08-21,2019-08-23,2,3226,844,445361,25.4,1031533675,2699082895,113164,310261,1,"공포(호러),스릴러",(주)에이스메이커무비웍스,남자,여자,남자,1
2836,변신,2019-08-21,2019-08-24,3,3516,931,503854,45.4,2058981647,4758064542,228498,538759,1,"공포(호러),스릴러",(주)에이스메이커무비웍스,남자,여자,남자,1
2837,변신,2019-08-21,2019-08-25,4,3653,975,532825,43.2,2088881900,6846946442,230239,768998,1,"공포(호러),스릴러",(주)에이스메이커무비웍스,남자,여자,남자,1
2838,변신,2019-08-21,2019-08-26,5,3638,893,548363,16.3,754373350,7601319792,89192,858190,1,"공포(호러),스릴러",(주)에이스메이커무비웍스,남자,여자,남자,1
2839,변신,2019-08-21,2019-08-27,6,3702,917,564257,14.5,687076880,8288396672,81681,939871,1,"공포(호러),스릴러",(주)에이스메이커무비웍스,남자,여자,남자,1
2840,변신,2019-08-21,2019-08-28,7,2701,822,413194,32.8,812900970,9101297642,135566,1075437,1,"공포(호러),스릴러",(주)에이스메이커무비웍스,남자,여자,남자,1
2841,변신,2019-08-21,2019-08-29,8,2868,779,441022,13.6,501774930,9603072572,59787,1135224,1,"공포(호러),스릴러",(주)에이스메이커무비웍스,남자,여자,남자,1
2842,변신,2019-08-21,2019-08-30,9,3194,879,504786,15.4,699483730,10302556302,77570,1212794,1,"공포(호러),스릴러",(주)에이스메이커무비웍스,남자,여자,남자,1
2843,변신,2019-08-21,2019-08-31,10,3672,934,602990,26.2,1411115710,11713672012,157900,1370694,1,"공포(호러),스릴러",(주)에이스메이커무비웍스,남자,여자,남자,1
2844,변신,2019-08-21,2019-09-01,11,3496,888,576045,22.3,1132455850,12846127862,128666,1499360,1,"공포(호러),스릴러",(주)에이스메이커무비웍스,남자,여자,남자,1
2845,변신,2019-08-21,2019-09-02,12,3149,794,505569,7.4,308276530,13154404392,37302,1536662,1,"공포(호러),스릴러",(주)에이스메이커무비웍스,남자,여자,남자,1
2846,변신,2019-08-21,2019-09-03,13,3095,804,494780,6.7,271237990,13425642382,33012,1569674,1,"공포(호러),스릴러",(주)에이스메이커무비웍스,남자,여자,남자,1
2847,변신,2019-08-21,2019-09-04,14,2566,718,385113,7.9,245808570,13671450952,30323,1599997,1,"공포(호러),스릴러",(주)에이스메이커무비웍스,남자,여자,남자,1
2848,변신,2019-08-21,2019-09-05,15,2356,709,355001,6.3,181298990,13852749942,22207,1622204,1,"공포(호러),스릴러",(주)에이스메이커무비웍스,남자,여자,남자,1
2849,변신,2019-08-21,2019-09-06,16,2420,699,363743,8.1,259324737,14112074679,29484,1651688,1,"공포(호러),스릴러",(주)에이스메이커무비웍스,남자,여자,남자,1
2850,변신,2019-08-21,2019-09-07,17,2409,728,354706,14.4,451974156,14564048835,51073,1702761,1,"공포(호러),스릴러",(주)에이스메이커무비웍스,남자,여자,남자,1
2851,변신,2019-08-21,2019-09-08,18,2315,720,342429,16.0,481340560,15045389395,54918,1757679,1,"공포(호러),스릴러",(주)에이스메이커무비웍스,남자,여자,남자,1
2852,변신,2019-08-21,2019-09-09,19,2038,635,290714,5.1,121576120,15166965515,14901,1772580,1,"공포(호러),스릴러",(주)에이스메이커무비웍스,남자,여자,남자,1
2853,변신,2019-08-21,2019-09-10,20,2050,660,294329,4.7,110816870,15277782385,13765,1786345,1,"공포(호러),스릴러",(주)에이스메이커무비웍스,남자,여자,남자,1
2854,변신,2019-08-21,2019-09-11,21,237,152,26712,11.2,23748180,15301530565,2983,1789328,1,"공포(호러),스릴러",(주)에이스메이커무비웍스,남자,여자,남자,1
2855,변신,2019-08-21,2019-09-12,22,168,119,18834,15.8,26903640,15328434205,2971,1792299,1,"공포(호러),스릴러",(주)에이스메이커무비웍스,남자,여자,남자,1
2856,변신,2019-08-21,2019-09-13,23,117,95,12859,17.1,19610480,15348044685,2195,1794494,1,"공포(호러),스릴러",(주)에이스메이커무비웍스,남자,여자,남자,1
2857,변신,2019-08-21,2019-09-14,24,95,82,10550,18.2,16154360,15364199045,1917,1796411,1,"공포(호러),스릴러",(주)에이스메이커무비웍스,남자,여자,남자,1
2858,변신,2019-08-21,2019-09-15,25,83,70,9086,15.2,11821340,15376020385,1385,1797796,1,"공포(호러),스릴러",(주)에이스메이커무비웍스,남자,여자,남자,1
2859,변신,2019-08-21,2019-09-16,26,126,92,14936,4.9,6150100,15382170485,727,1798523,1,"공포(호러),스릴러",(주)에이스메이커무비웍스,남자,여자,남자,1
2860,변신,2019-08-21,2019-09-17,27,110,84,13093,4.2,4491100,15386661585,550,1799073,1,"공포(호러),스릴러",(주)에이스메이커무비웍스,남자,여자,남자,1
2861,변신,2019-08-21,2019-09-18,28,30,22,3572,4.2,1293800,15387955385,151,1799224,1,"공포(호러),스릴러",(주)에이스메이커무비웍스,남자,여자,남자,1
2862,변신,2019-08-21,2019-09-19,29,7,7,1031,15.0,776600,15388731985,155,1799379,1,"공포(호러),스릴러",(주)에이스메이커무비웍스,남자,여자,남자,1
2863,변신,2019-08-21,2019-09-20,30,9,8,1264,13.3,878000,15389609985,168,1799547,1,"공포(호러),스릴러",(주)에이스메이커무비웍스,남자,여자,남자,1
2864,변신,2019-08-21,2019-09-21,31,9,7,1310,14.6,1086480,15390696465,191,1799738,1,"공포(호러),스릴러",(주)에이스메이커무비웍스,남자,여자,남자,1
2865,변신,2019-08-21,2019-09-22,32,8,7,1069,16.7,971500,15391667965,178,1799916,1,"공포(호러),스릴러",(주)에이스메이커무비웍스,남자,여자,남자,1
2866,변신,2019-08-21,2019-09-23,33,6,6,807,19.1,785000,15392452965,154,1800070,1,"공포(호러),스릴러",(주)에이스메이커무비웍스,남자,여자,남자,1
2867,변신,2019-08-21,2019-09-24,34,22,22,2347,27.6,3284960,15395737925,647,1800717,1,"공포(호러),스릴러",(주)에이스메이커무비웍스,남자,여자,남자,1
2868,변신,2019-08-21,2019-09-25,35,7,7,1053,18.0,945000,15396682925,189,1800906,1,"공포(호러),스릴러",(주)에이스메이커무비웍스,남자,여자,남자,1
2869,변신,2019-08-21,2019-09-26,36,12,12,1840,32.0,4121000,15400803925,588,1801494,1,"공포(호러),스릴러",(주)에이스메이커무비웍스,남자,여자,남자,1
2870,변신,2019-08-21,2019-09-27,37,8,8,1043,21.8,1138000,15401941925,227,1801721,1,"공포(호러),스릴러",(주)에이스메이커무비웍스,남자,여자,남자,1
2871,변신,2019-08-21,2019-09-28,38,5,5,761,19.7,750000,15402691925,150,1801871,1,"공포(호러),스릴러",(주)에이스메이커무비웍스,남자,여자,남자,1
2872,변신,2019-08-21,2019-09-29,39,5,5,736,20.4,750000,15403441925,150,1802021,1,"공포(호러),스릴러",(주)에이스메이커무비웍스,남자,여자,남자,1
2873,변신,2019-08-21,2019-09-30,40,6,6,859,20.3,872000,15404313925,174,1802195,1,"공포(호러),스릴러",(주)에이스메이커무비웍스,남자,여자,남자,1
2874,변신,2019-08-21,2019-10-01,41,6,6,914,18.3,843000,15405156925,167,1802362,1,"공포(호러),스릴러",(주)에이스메이커무비웍스,남자,여자,남자,1
2875,변신,2019-08-21,2019-10-02,42,5,5,806,18.6,750000,15405906925,150,1802512,1,"공포(호러),스릴러",(주)에이스메이커무비웍스,남자,여자,남자,1
2876,변신,2019-08-21,2019-10-03,43,5,5,726,20.7,750000,15406656925,150,1802662,1,"공포(호러),스릴러",(주)에이스메이커무비웍스,남자,여자,남자,1
2877,변신,2019-08-21,2019-10-04,44,5,5,728,20.6,750000,15407406925,150,1802812,1,"공포(호러),스릴러",(주)에이스메이커무비웍스,남자,여자,남자,1
2878,변신,2019-08-21,2019-10-05,45,5,5,700,21.4,750000,15408156925,150,1802962,1,"공포(호러),스릴러",(주)에이스메이커무비웍스,남자,여자,남자,1
2879,변신,2019-08-21,2019-10-06,46,5,5,698,21.5,750000,15408906925,150,1803112,1,"공포(호러),스릴러",(주)에이스메이커무비웍스,남자,여자,남자,1
2880,변신,2019-08-21,2019-10-07,47,5,5,815,18.4,750000,15409656925,150,1803262,1,"공포(호러),스릴러",(주)에이스메이커무비웍스,남자,여자,남자,1
2881,변신,2019-08-21,2019-10-22,62,1,1,268,87.3,2106000,15411762925,234,1803496,1,"공포(호러),스릴러",(주)에이스메이커무비웍스,남자,여자,남자,1
2882,유열의 음악앨범,2019-08-28,2019-08-14,-14,2,2,342,100.0,3078000,3078000,342,342,2,"멜로/로맨스,드라마",CGV아트하우스,남자,여자,여자,2
2883,유열의 음악앨범,2019-08-28,2019-08-20,-8,7,6,1922,99.2,17154000,20232000,1907,2249,2,"멜로/로맨스,드라마",CGV아트하우스,남자,여자,여자,2
2884,유열의 음악앨범,2019-08-28,2019-08-21,-7,5,5,1162,96.8,10125000,30357000,1125,3374,2,"멜로/로맨스,드라마",CGV아트하우스,남자,여자,여자,2
2885,유열의 음악앨범,2019-08-28,2019-08-22,-6,10,10,2229,99.2,19899000,50256000,2211,5585,2,"멜로/로맨스,드라마",CGV아트하우스,남자,여자,여자,2
2886,유열의 음악앨범,2019-08-28,2019-08-24,-4,14,14,4161,86.7,36966480,87222480,3606,9191,2,"멜로/로맨스,드라마",CGV아트하우스,남자,여자,여자,2
2887,유열의 음악앨범,2019-08-28,2019-08-25,-3,12,12,2910,84.6,25421060,112643540,2463,11654,2,"멜로/로맨스,드라마",CGV아트하우스,남자,여자,여자,2
2888,유열의 음악앨범,2019-08-28,2019-08-26,-2,23,23,5640,100.0,50272000,162915540,5640,17294,2,"멜로/로맨스,드라마",CGV아트하우스,남자,여자,여자,2
2889,유열의 음악앨범,2019-08-28,2019-08-27,-1,23,23,4540,54.9,26343600,189259140,2491,19785,2,"멜로/로맨스,드라마",CGV아트하우스,남자,여자,여자,2
2890,유열의 음악앨범,2019-08-28,2019-08-28,0,4549,1052,854225,20.3,1027952800,1217211940,173513,193298,2,"멜로/로맨스,드라마",CGV아트하우스,남자,여자,여자,2
2891,유열의 음악앨범,2019-08-28,2019-08-29,1,4559,1004,848296,9.3,647532120,1864744060,79110,272408,2,"멜로/로맨스,드라마",CGV아트하우스,남자,여자,여자,2
2892,유열의 음악앨범,2019-08-28,2019-08-30,2,4704,1034,877859,11.1,867341880,2732085940,97637,370045,2,"멜로/로맨스,드라마",CGV아트하우스,남자,여자,여자,2
2893,유열의 음악앨범,2019-08-28,2019-08-31,3,4955,1078,915681,18.5,1502117100,4234203040,169207,539252,2,"멜로/로맨스,드라마",CGV아트하우스,남자,여자,여자,2
2894,유열의 음악앨범,2019-08-28,2019-09-01,4,4696,1032,875883,16.6,1276019900,5510222940,145265,684517,2,"멜로/로맨스,드라마",CGV아트하우스,남자,여자,여자,2
2895,유열의 음악앨범,2019-08-28,2019-09-02,5,4284,974,793883,7.0,453429590,5963652530,55865,740382,2,"멜로/로맨스,드라마",CGV아트하우스,남자,여자,여자,2
2896,유열의 음악앨범,2019-08-28,2019-09-03,6,4280,989,792038,7.2,461554880,6425207410,56868,797250,2,"멜로/로맨스,드라마",CGV아트하우스,남자,여자,여자,2
2897,유열의 음악앨범,2019-08-28,2019-09-04,7,3231,817,545445,9.0,391149460,6816356870,48817,846067,2,"멜로/로맨스,드라마",CGV아트하우스,남자,여자,여자,2
2898,유열의 음악앨범,2019-08-28,2019-09-05,8,3134,812,540237,7.6,330550600,7146907470,41188,887255,2,"멜로/로맨스,드라마",CGV아트하우스,남자,여자,여자,2
2899,유열의 음악앨범,2019-08-28,2019-09-06,9,3288,845,561899,9.3,453462140,7600369610,52001,939256,2,"멜로/로맨스,드라마",CGV아트하우스,남자,여자,여자,2
2900,유열의 음악앨범,2019-08-28,2019-09-07,10,3528,908,616437,14.3,776354460,8376724070,87958,1027214,2,"멜로/로맨스,드라마",CGV아트하우스,남자,여자,여자,2
2901,유열의 음악앨범,2019-08-28,2019-09-08,11,3405,879,595910,15.1,783246370,9159970440,90199,1117413,2,"멜로/로맨스,드라마",CGV아트하우스,남자,여자,여자,2
2902,유열의 음악앨범,2019-08-28,2019-09-09,12,3212,852,560281,4.9,220321590,9380292030,27462,1144875,2,"멜로/로맨스,드라마",CGV아트하우스,남자,여자,여자,2
2903,유열의 음악앨범,2019-08-28,2019-09-10,13,3169,860,550448,4.8,214787640,9595079670,26595,1171470,2,"멜로/로맨스,드라마",CGV아트하우스,남자,여자,여자,2
2904,유열의 음악앨범,2019-08-28,2019-09-11,14,658,321,81823,14.4,94970370,9690050040,11778,1183248,2,"멜로/로맨스,드라마",CGV아트하우스,남자,여자,여자,2
2905,유열의 음악앨범,2019-08-28,2019-09-12,15,507,299,61725,21.1,117397390,9807447430,13026,1196274,2,"멜로/로맨스,드라마",CGV아트하우스,남자,여자,여자,2
2906,유열의 음악앨범,2019-08-28,2019-09-13,16,416,263,50889,19.2,89259740,9896707170,9788,1206062,2,"멜로/로맨스,드라마",CGV아트하우스,남자,여자,여자,2
2907,유열의 음악앨범,2019-08-28,2019-09-14,17,354,231,42631,27.1,102595550,9999302720,11548,1217610,2,"멜로/로맨스,드라마",CGV아트하우스,남자,여자,여자,2
2908,유열의 음악앨범,2019-08-28,2019-09-15,18,332,227,40810,19.5,70139340,10069442060,7944,1225554,2,"멜로/로맨스,드라마",CGV아트하우스,남자,여자,여자,2
2909,유열의 음악앨범,2019-08-28,2019-09-16,19,524,300,63628,6.5,33399010,10102841070,4162,1229716,2,"멜로/로맨스,드라마",CGV아트하우스,남자,여자,여자,2
2910,유열의 음악앨범,2019-08-28,2019-09-17,20,511,292,64023,5.6,29061460,10131902530,3572,1233288,2,"멜로/로맨스,드라마",CGV아트하우스,남자,여자,여자,2
2911,유열의 음악앨범,2019-08-28,2019-09-18,21,295,166,38706,5.7,17632120,10149534650,2202,1235490,2,"멜로/로맨스,드라마",CGV아트하우스,남자,여자,여자,2
2912,유열의 음악앨범,2019-08-28,2019-09-19,22,139,102,16367,6.2,8402300,10157936950,1016,1236506,2,"멜로/로맨스,드라마",CGV아트하우스,남자,여자,여자,2
2913,유열의 음악앨범,2019-08-28,2019-09-20,23,150,105,16953,6.6,10098290,10168035240,1116,1237622,2,"멜로/로맨스,드라마",CGV아트하우스,남자,여자,여자,2
2914,유열의 음악앨범,2019-08-28,2019-09-21,24,117,92,13286,14.4,16800330,10184835570,1907,1239529,2,"멜로/로맨스,드라마",CGV아트하우스,남자,여자,여자,2
2915,유열의 음악앨범,2019-08-28,2019-09-22,25,111,93,12849,11.3,12661770,10197497340,1446,1240975,2,"멜로/로맨스,드라마",CGV아트하우스,남자,여자,여자,2
2916,유열의 음악앨범,2019-08-28,2019-09-23,26,127,95,14802,4.6,5270770,10202768110,680,1241655,2,"멜로/로맨스,드라마",CGV아트하우스,남자,여자,여자,2
2917,유열의 음악앨범,2019-08-28,2019-09-24,27,126,95,14835,6.7,7503320,10210271430,987,1242642,2,"멜로/로맨스,드라마",CGV아트하우스,남자,여자,여자,2
2918,유열의 음악앨범,2019-08-28,2019-09-25,28,15,14,1286,28.8,2573960,10212845390,370,1243012,2,"멜로/로맨스,드라마",CGV아트하우스,남자,여자,여자,2
2919,유열의 음악앨범,2019-08-28,2019-09-26,29,18,17,2191,33.7,6354300,10219199690,739,1243751,2,"멜로/로맨스,드라마",CGV아트하우스,남자,여자,여자,2
2920,유열의 음악앨범,2019-08-28,2019-09-27,30,11,10,1116,7.8,759500,10219959190,87,1243838,2,"멜로/로맨스,드라마",CGV아트하우스,남자,여자,여자,2
2921,유열의 음악앨범,2019-08-28,2019-09-28,31,15,15,1467,10.5,1325450,10221284640,154,1243992,2,"멜로/로맨스,드라마",CGV아트하우스,남자,여자,여자,2
2922,유열의 음악앨범,2019-08-28,2019-09-29,32,13,13,1304,12.0,1334600,10222619240,156,1244148,2,"멜로/로맨스,드라마",CGV아트하우스,남자,여자,여자,2
2923,유열의 음악앨범,2019-08-28,2019-09-30,33,20,19,2506,22.3,4890300,10227509540,559,1244707,2,"멜로/로맨스,드라마",CGV아트하우스,남자,여자,여자,2
2924,유열의 음악앨범,2019-08-28,2019-10-01,34,12,12,1281,4.8,472000,10227981540,62,1244769,2,"멜로/로맨스,드라마",CGV아트하우스,남자,여자,여자,2
2925,유열의 음악앨범,2019-08-28,2019-10-02,35,8,8,790,3.7,211500,10228193040,29,1244798,2,"멜로/로맨스,드라마",CGV아트하우스,남자,여자,여자,2
2926,유열의 음악앨범,2019-08-28,2019-10-03,36,6,6,479,20.9,740000,10228933040,100,1244898,2,"멜로/로맨스,드라마",CGV아트하우스,남자,여자,여자,2
2927,유열의 음악앨범,2019-08-28,2019-10-04,37,6,6,551,14.0,538000,10229471040,77,1244975,2,"멜로/로맨스,드라마",CGV아트하우스,남자,여자,여자,2
2928,유열의 음악앨범,2019-08-28,2019-10-05,38,6,6,477,18.7,698000,10230169040,89,1245064,2,"멜로/로맨스,드라마",CGV아트하우스,남자,여자,여자,2
2929,유열의 음악앨범,2019-08-28,2019-10-06,39,5,5,419,12.4,365000,10230534040,52,1245116,2,"멜로/로맨스,드라마",CGV아트하우스,남자,여자,여자,2
2930,유열의 음악앨범,2019-08-28,2019-10-07,40,3,3,232,3.5,56000,10230590040,8,1245124,2,"멜로/로맨스,드라마",CGV아트하우스,남자,여자,여자,2
2931,유열의 음악앨범,2019-08-28,2019-10-08,41,7,7,593,21.6,774000,10231364040,128,1245252,2,"멜로/로맨스,드라마",CGV아트하우스,남자,여자,여자,2
2932,유열의 음악앨범,2019-08-28,2019-10-09,42,5,5,425,20.5,622000,10231986040,87,1245339,2,"멜로/로맨스,드라마",CGV아트하우스,남자,여자,여자,2
2933,유열의 음악앨범,2019-08-28,2019-10-10,43,3,3,300,11.0,235000,10232221040,33,1245372,2,"멜로/로맨스,드라마",CGV아트하우스,남자,여자,여자,2
2934,유열의 음악앨범,2019-08-28,2019-10-11,44,3,3,300,11.7,251000,10232472040,35,1245407,2,"멜로/로맨스,드라마",CGV아트하우스,남자,여자,여자,2
2935,유열의 음악앨범,2019-08-28,2019-10-12,45,3,3,300,13.0,294000,10232766040,39,1245446,2,"멜로/로맨스,드라마",CGV아트하우스,남자,여자,여자,2
2936,유열의 음악앨범,2019-08-28,2019-10-13,46,3,3,300,10.0,210000,10232976040,30,1245476,2,"멜로/로맨스,드라마",CGV아트하우스,남자,여자,여자,2
2937,유열의 음악앨범,2019-08-28,2019-10-14,47,3,3,372,9.7,263000,10233239040,36,1245512,2,"멜로/로맨스,드라마",CGV아트하우스,남자,여자,여자,2
2938,유열의 음악앨범,2019-08-28,2019-10-20,53,1,1,8,100.0,96000,10233335040,8,1245520,2,"멜로/로맨스,드라마",CGV아트하우스,남자,여자,여자,2
