영화코드,영화명,개봉일,점유율집계일,개봉n일차,개봉n일차(int),상영횟수,상영점유율,상영점유율순위,스크린수,스크린점유율,스크린점유율순위,좌석수,좌석판매율,좌석점유율,좌석점유율순위,매출액,누적매출액,관객수,누적관객수
20148048,베테랑,2015-08-05,2015-08-05,0 days 00:00:00.000000000,0,5096,58.852,1,957,51.1,1,916883,45.2,34.82,1,3129197200,3332719600,414219,439640
20148048,베테랑,2015-08-05,2015-08-06,1 days 00:00:00.000000000,1,5009,58.475,1,942,51.9,1,905532,44.7,34.3,1,3062333800,6395053400,404907,844547
20148048,베테랑,2015-08-05,2015-08-07,2 days 00:00:00.000000000,2,5100,57.849,1,984,51.3,1,921369,51.9,34.38,1,3822836218,10217889618,477754,1322301
20148048,베테랑,2015-08-05,2015-08-08,3 days 00:00:00.000000000,3,5332,58.02,1,1034,52.0,1,964650,74.2,35.27,1,5744084405,15961974023,715334,2037635
20148048,베테랑,2015-08-05,2015-08-09,4 days 00:00:00.000000000,4,5349,58.838,1,1064,53.6,1,971012,74.6,36.1,1,5819291900,21781265923,723999,2761634
20148048,베테랑,2015-08-05,2015-08-10,5 days 00:00:00.000000000,5,5226,58.831,1,1016,52.2,1,965235,43.6,37.25,1,3180133300,24961399223,420701,3182335
20148048,베테랑,2015-08-05,2015-08-11,6 days 00:00:00.000000000,6,5258,58.422,1,1040,50.3,1,974081,41.9,37.56,1,3069469900,28030869123,407694,3590029
20148048,베테랑,2015-08-05,2015-08-12,7 days 00:00:00.000000000,7,5405,59.592,1,1057,53.1,1,1014781,38.7,38.96,1,2960267600,30991136723,392815,3982844
20148048,베테랑,2015-08-05,2015-08-13,8 days 00:00:00.000000000,8,4814,39.599,1,907,33.3,1,987971,41.2,36.74,1,3079775800,34070912523,406788,4389632
20148048,베테랑,2015-08-05,2015-08-14,9 days 00:00:00.000000000,9,5235,42.327,1,1034,35.2,1,1068402,66.9,38.7,1,5721321489,39792234012,715051,5104683
20148048,베테랑,2015-08-05,2015-08-15,10 days 00:00:00.000000000,10,5629,45.88399999999999,1,1115,37.2,1,1140118,72.6,41.09,1,6658053353,46450287365,827984,5932667
20148048,베테랑,2015-08-05,2015-08-16,11 days 00:00:00.000000000,11,5523,46.287,1,1110,36.6,1,1120502,63.5,41.28,1,5736846100,52187133465,711071,6643738
20148048,베테랑,2015-08-05,2015-08-17,12 days 00:00:00.000000000,12,5054,43.803,1,964,35.7,1,1028312,30.2,40.32,1,2360041900,54547175365,310651,6954389
20148048,베테랑,2015-08-05,2015-08-18,13 days 00:00:00.000000000,13,5065,44.00899999999999,1,973,35.4,1,1031387,26.7,40.37,1,2085923100,56633098465,275747,7230136
20148048,베테랑,2015-08-05,2015-08-19,14 days 00:00:00.000000000,14,5063,44.187,1,983,35.5,1,1024081,23.9,40.24,1,1852684700,58485783165,244240,7474376
20148048,베테랑,2015-08-05,2015-08-20,15 days 00:00:00.000000000,15,4184,36.122,1,813,26.8,1,868041,25.8,32.99,1,1701067000,60186850165,223836,7698212
20148048,베테랑,2015-08-05,2015-08-21,16 days 00:00:00.000000000,16,4331,36.669,1,825,27.4,1,898623,31.8,33.72,1,2311128525,62497978690,285776,7983988
20148048,베테랑,2015-08-05,2015-08-22,17 days 00:00:00.000000000,17,4736,39.076,1,906,29.2,1,979831,54.7,35.77,1,4354341431,66852320121,535808,8519796
20148048,베테랑,2015-08-05,2015-08-23,18 days 00:00:00.000000000,18,4633,39.12300000000001,1,892,29.2,1,960194,54.6,35.88,1,4228577200,71080897321,524191,9043987
20148048,베테랑,2015-08-05,2015-08-24,19 days 00:00:00.000000000,19,4240,37.186,1,809,27.5,1,876649,19.3,35.18,1,1285800600,72366697921,169321,9213308
20148048,베테랑,2015-08-05,2015-08-25,20 days 00:00:00.000000000,20,4228,37.343,1,824,27.5,1,871084,20.9,35.23,1,1372123700,73738821621,181855,9395163
20148048,베테랑,2015-08-05,2015-08-26,21 days 00:00:00.000000000,21,4269,37.401,1,836,27.3,1,885524,22.6,35.8,1,1306119200,75044940821,200266,9595429
20148048,베테랑,2015-08-05,2015-08-27,22 days 00:00:00.000000000,22,4271,36.969,1,839,30.6,1,887913,15.6,35.05,1,1041683100,76086623921,138587,9734016
20148048,베테랑,2015-08-05,2015-08-28,23 days 00:00:00.000000000,23,4428,37.279,1,843,29.8,1,917732,21.0,35.4,1,1541283577,77627907498,192462,9926478
20148048,베테랑,2015-08-05,2015-08-29,24 days 00:00:00.000000000,24,4677,37.782,1,876,29.2,1,980453,46.4,36.36,1,3689736628,81317644126,454912,10381390
20148048,베테랑,2015-08-05,2015-08-30,25 days 00:00:00.000000000,25,4571,37.846,1,873,29.6,1,957675,45.2,36.47,1,3469678000,84787322126,432706,10814096
20148048,베테랑,2015-08-05,2015-08-31,26 days 00:00:00.000000000,26,4262,36.811,1,828,29.8,1,881816,16.4,35.6,1,1072549100,85859871226,144260,10958356
20148048,베테랑,2015-08-05,2015-09-01,27 days 00:00:00.000000000,27,4223,36.824,1,834,29.2,1,873667,14.0,35.74,1,907287100,86767158326,122026,11080382
20148048,베테랑,2015-08-05,2015-09-02,28 days 00:00:00.000000000,28,4203,36.727,1,833,29.1,1,868194,13.0,35.69,1,840111200,87607269526,112792,11193174
20148048,베테랑,2015-08-05,2015-09-03,29 days 00:00:00.000000000,29,2748,35.249,1,611,26.2,1,494527,17.6,19.54,1,650953100,88258222626,87190,11280364
20148048,베테랑,2015-08-05,2015-09-04,30 days 00:00:00.000000000,30,2864,35.635,1,621,26.1,1,513547,22.8,19.75,1,935572433,89193795059,116808,11397172
20148048,베테랑,2015-08-05,2015-09-05,31 days 00:00:00.000000000,31,3200,38.54,1,669,27.6,1,571543,45.0,21.06,1,2099799473,91293594532,257263,11654435
20148048,베테랑,2015-08-05,2015-09-06,32 days 00:00:00.000000000,32,3131,38.535,1,669,27.6,1,555565,40.9,20.98,1,1840691800,93134286332,227365,11881800
20148048,베테랑,2015-08-05,2015-09-07,33 days 00:00:00.000000000,33,2833,36.602,1,612,26.8,1,501114,13.4,20.24,1,499532200,93633818532,67059,11948859
20148048,베테랑,2015-08-05,2015-09-08,34 days 00:00:00.000000000,34,2820,36.42,1,617,26.5,1,499543,11.7,20.33,1,435645800,94069464332,58658,12007517
20148048,베테랑,2015-08-05,2015-09-09,35 days 00:00:00.000000000,35,2806,36.404,1,622,26.8,1,496094,11.6,20.27,1,415730600,94485194932,57463,12064980
20148048,베테랑,2015-08-05,2015-09-10,36 days 00:00:00.000000000,36,2810,36.366,1,615,24.6,1,491772,10.7,19.99,1,392834400,94878029332,52595,12117575
20148048,베테랑,2015-08-05,2015-09-11,37 days 00:00:00.000000000,37,2928,36.274,1,633,24.6,1,511591,14.1,20.17,1,579609300,95457638632,72154,12189729
20148048,베테랑,2015-08-05,2015-09-12,38 days 00:00:00.000000000,38,3213,37.461,1,674,24.5,1,569966,29.3,21.32,1,1366657200,96824295832,167184,12356913
20148048,베테랑,2015-08-05,2015-09-13,39 days 00:00:00.000000000,39,3111,37.089,1,658,24.2,1,550288,25.5,21.13,1,1145612400,97969908232,140466,12497379
20148048,베테랑,2015-08-05,2015-09-14,40 days 00:00:00.000000000,40,2823,36.229,1,622,24.3,1,494049,9.1,20.57,1,338333700,98308241932,45068,12542447
20148048,베테랑,2015-08-05,2015-09-15,41 days 00:00:00.000000000,41,2808,36.293,1,627,24.0,1,491530,8.5,20.72,1,311391200,98619633132,41749,12584196
20148048,베테랑,2015-08-05,2015-09-16,42 days 00:00:00.000000000,42,1322,15.005999999999998,2,399,16.6,2,168920,14.6,7.01,2,183204000,98802837132,24714,12608910
20148048,베테랑,2015-08-05,2015-09-17,43 days 00:00:00.000000000,43,1270,14.503,2,395,17.4,2,156738,16.3,6.51,2,191005100,98993842232,25570,12634480
20148048,베테랑,2015-08-05,2015-09-18,44 days 00:00:00.000000000,44,1304,14.511,2,405,17.6,2,160615,19.7,6.47,2,254546115,99248388347,31713,12666193
20148048,베테랑,2015-08-05,2015-09-19,45 days 00:00:00.000000000,45,1275,14.04,2,423,18.8,2,156486,39.5,6.04,2,508578103,99756966450,61871,12728064
20148048,베테랑,2015-08-05,2015-09-20,46 days 00:00:00.000000000,46,1256,14.265999999999998,2,424,19.1,2,155069,37.9,6.14,2,478360400,100235326850,58782,12786846
20148048,베테랑,2015-08-05,2015-09-21,47 days 00:00:00.000000000,47,1323,15.503,2,404,18.4,2,163386,14.4,6.9,2,175290100,100410616950,23500,12810346
20148048,베테랑,2015-08-05,2015-09-22,48 days 00:00:00.000000000,48,1337,15.667,2,408,18.2,2,165561,13.7,7.0,2,169099000,100579715950,22619,12832965
20148048,베테랑,2015-08-05,2015-09-23,49 days 00:00:00.000000000,49,1345,15.890999999999998,2,410,18.6,2,168090,13.7,7.13,2,171887700,100751603650,23035,12856000
20148048,베테랑,2015-08-05,2015-09-24,50 days 00:00:00.000000000,50,506,5.539,4,253,11.3,4,64999,19.0,2.58,4,92068600,100843672250,12362,12868362
20148048,베테랑,2015-08-05,2015-09-25,51 days 00:00:00.000000000,51,562,5.877000000000002,4,273,12.1,4,72217,34.1,2.74,4,196913100,101040585350,24606,12892968
20148048,베테랑,2015-08-05,2015-09-26,52 days 00:00:00.000000000,52,659,6.574,4,320,13.4,4,86546,55.4,3.12,4,392813700,101433399050,47951,12940919
20148048,베테랑,2015-08-05,2015-09-27,53 days 00:00:00.000000000,53,812,7.898,4,389,14.9,4,107739,69.9,3.91,4,627253900,102060652950,75340,13016259
20148048,베테랑,2015-08-05,2015-09-28,54 days 00:00:00.000000000,54,984,9.144,4,453,16.1,4,137095,77.3,4.87,4,863787800,102924440750,105903,13122162
20148048,베테랑,2015-08-05,2015-09-29,55 days 00:00:00.000000000,55,905,8.757,4,429,15.6,4,125799,70.0,4.64,4,707876600,103632317350,88104,13210266
20148048,베테랑,2015-08-05,2015-09-30,56 days 00:00:00.000000000,56,576,6.392,4,272,11.1,4,75494,39.5,3.0,4,206451300,103838768650,29799,13240065
20148048,베테랑,2015-08-05,2015-10-01,57 days 00:00:00.000000000,57,527,6.079,4,243,10.2,5,67841,27.2,2.71,4,113595500,103952364150,18426,13258491
20148048,베테랑,2015-08-05,2015-10-02,58 days 00:00:00.000000000,58,567,6.5120000000000005,4,255,10.8,4,72207,23.5,2.85,4,135335100,104087699250,16941,13275432
20148048,베테랑,2015-08-05,2015-10-03,59 days 00:00:00.000000000,59,690,7.686,4,294,12.2,4,90018,40.2,3.4,4,293779600,104381478850,36165,13311597
20148048,베테랑,2015-08-05,2015-10-04,60 days 00:00:00.000000000,60,670,7.775,4,292,12.3,4,86960,33.9,3.38,4,239978300,104621457150,29470,13341067
20148048,베테랑,2015-08-05,2015-10-05,61 days 00:00:00.000000000,61,636,7.892,4,272,12.3,4,82320,12.6,3.48,4,77031900,104698489050,10342,13351409
20148048,베테랑,2015-08-05,2015-10-06,62 days 00:00:00.000000000,62,610,7.57,4,263,11.3,4,79300,12.1,3.37,4,71387500,104769876550,9616,13361025
20148048,베테랑,2015-08-05,2015-10-07,63 days 00:00:00.000000000,63,634,7.98,4,274,12.0,4,81902,12.3,3.47,4,75356200,104845232750,10073,13371098
20148048,베테랑,2015-08-05,2015-10-08,64 days 00:00:00.000000000,64,162,2.638,4,102,5.4,4,18981,19.5,0.78,4,27524600,104872757350,3703,13374801
20148048,베테랑,2015-08-05,2015-10-09,65 days 00:00:00.000000000,65,180,2.888,5,106,5.5,5,21419,41.7,0.83,5,70903900,104943661250,8921,13383722
20148048,베테랑,2015-08-05,2015-10-10,66 days 00:00:00.000000000,66,176,2.886,5,110,5.6,5,21360,36.5,0.81,5,63550700,105007211950,7786,13391508
20148048,베테랑,2015-08-05,2015-10-11,67 days 00:00:00.000000000,67,170,2.906,5,105,5.4,5,20264,30.9,0.8,5,51269700,105058481650,6254,13397762
20148048,베테랑,2015-08-05,2015-10-12,68 days 00:00:00.000000000,68,181,3.192,4,105,6.1,4,22340,8.4,0.96,4,13482000,105071963650,1867,13399629
20148048,베테랑,2015-08-05,2015-10-13,69 days 00:00:00.000000000,69,177,3.122,4,106,6.0,4,22038,8.4,0.95,4,12494000,105084457650,1845,13401474
20148048,베테랑,2015-08-05,2015-10-14,70 days 00:00:00.000000000,70,170,3.029,4,102,5.8,4,20911,9.3,0.9,4,10956500,105095414150,1940,13403414
20148048,베테랑,2015-08-05,2015-10-15,71 days 00:00:00.000000000,71,56,1.242,6,37,2.4,6,6118,10.1,0.25,6,4739500,105100153650,619,13404033
20148048,베테랑,2015-08-05,2015-10-16,72 days 00:00:00.000000000,72,59,1.251,6,41,2.5,5,6674,12.1,0.27,7,6364200,105106517850,809,13404842
20148048,베테랑,2015-08-05,2015-10-17,73 days 00:00:00.000000000,73,59,1.237,6,46,2.8,5,7306,17.7,0.28,5,10749100,105117266950,1292,13406134
20148048,베테랑,2015-08-05,2015-10-18,74 days 00:00:00.000000000,74,58,1.24,6,44,2.7,5,7235,18.0,0.29,7,10570900,105127837850,1301,13407435
20148048,베테랑,2015-08-05,2015-10-19,75 days 00:00:00.000000000,75,58,1.305,6,38,2.5,5,6868,7.6,0.29,6,3993500,105131831350,521,13407956
20148048,베테랑,2015-08-05,2015-10-20,76 days 00:00:00.000000000,76,58,1.325,6,36,2.3,5,6757,7.7,0.29,5,3890000,105135721350,519,13408475
20148048,베테랑,2015-08-05,2015-10-21,77 days 00:00:00.000000000,77,53,1.22,6,34,2.2,5,6225,7.9,0.27,6,3657500,105139378850,492,13408967
20148048,베테랑,2015-08-05,2015-10-22,78 days 00:00:00.000000000,78,4,0.042,18,4,0.2,16,408,10.1,0.02,18,301000,105139679850,41,13409008
20148048,베테랑,2015-08-05,2015-10-23,79 days 00:00:00.000000000,79,7,0.07200000000000001,13,7,0.3,12,977,10.8,0.04,14,872000,105140551850,105,13409113
20148048,베테랑,2015-08-05,2015-10-24,80 days 00:00:00.000000000,80,7,0.07,12,7,0.3,12,829,37.9,0.03,13,2297000,105142848850,314,13409427
20148048,베테랑,2015-08-05,2015-10-25,81 days 00:00:00.000000000,81,7,0.073,12,7,0.3,12,890,16.4,0.03,13,1265000,105144113850,146,13409573
20148048,베테랑,2015-08-05,2015-10-26,82 days 00:00:00.000000000,82,10,0.112,12,7,0.3,12,1676,28.1,0.07,12,2195000,105146308850,471,13410044
20148048,베테랑,2015-08-05,2015-10-27,83 days 00:00:00.000000000,83,9,0.101,11,6,0.2,11,1408,30.9,0.06,11,1917500,105148226350,435,13410479
20148048,베테랑,2015-08-05,2015-10-28,84 days 00:00:00.000000000,84,8,0.092,14,8,0.3,14,1023,24.2,0.04,17,1270000,105149496350,248,13410727
20148048,베테랑,2015-08-05,2015-10-29,85 days 00:00:00.000000000,85,4,0.047,20,4,0.2,19,586,2.4,0.02,20,112000,105149608350,14,13410741
20148048,베테랑,2015-08-05,2015-10-30,86 days 00:00:00.000000000,86,5,0.056,16,5,0.2,16,676,5.2,0.03,16,297000,105149905350,35,13410776
20148048,베테랑,2015-08-05,2015-10-31,87 days 00:00:00.000000000,87,7,0.075,17,7,0.3,15,854,5.6,0.03,16,359000,105150264350,48,13410824
20148048,베테랑,2015-08-05,2015-11-01,88 days 00:00:00.000000000,88,8,0.08800000000000001,16,8,0.3,14,1123,4.6,0.04,15,398000,105150662350,52,13410876
20148048,베테랑,2015-08-05,2015-11-02,89 days 00:00:00.000000000,89,6,0.073,16,6,0.3,16,864,3.1,0.04,17,215400,105150877750,27,13410903
20148048,베테랑,2015-08-05,2015-11-03,90 days 00:00:00.000000000,90,5,0.061,18,5,0.2,17,778,4.1,0.03,17,243000,105151120750,32,13410935
20148048,베테랑,2015-08-05,2015-11-04,91 days 00:00:00.000000000,91,6,0.073,14,6,0.3,14,883,3.6,0.04,13,248500,105151369250,32,13410967
20148048,베테랑,2015-08-05,2015-11-05,92 days 00:00:00.000000000,92,3,0.037000000000000005,17,1,0.1,23,858,21.9,0.03,13,564000,105151933250,188,13411155
20148048,베테랑,2015-08-05,2015-11-06,93 days 00:00:00.000000000,93,3,0.035,19,1,0.1,22,858,21.7,0.03,14,558000,105152491250,186,13411341
20148048,베테랑,2015-08-05,2015-11-07,94 days 00:00:00.000000000,94,3,0.032,19,1,0.0,21,858,28.9,0.03,15,748000,105153239250,248,13411589
20148048,베테랑,2015-08-05,2015-11-09,96 days 00:00:00.000000000,96,3,0.036000000000000004,18,1,0.1,19,858,26.2,0.03,13,675000,105153914250,225,13411814
20148048,베테랑,2015-08-05,2015-11-10,97 days 00:00:00.000000000,97,3,0.036000000000000004,20,1,0.1,23,858,15.3,0.03,15,393000,105154307250,131,13411945
20148048,베테랑,2015-08-05,2015-11-11,98 days 00:00:00.000000000,98,3,0.046,18,1,0.1,20,858,15.6,0.04,11,402000,105154709250,134,13412079
20148048,베테랑,2015-08-05,2015-11-13,100 days 00:00:00.000000000,100,2,0.029,18,2,0.1,17,187,0.0,0.01,18,0,105154709250,0,13412079
20148048,베테랑,2015-08-05,2015-11-15,102 days 00:00:00.000000000,102,1,0.014,21,1,0.1,17,285,87.7,0.01,15,2500000,105157209250,250,13412329
20148048,베테랑,2015-08-05,2015-11-18,105 days 00:00:00.000000000,105,1,0.014,25,1,0.0,21,85,0.0,0.0,30,0,105157209250,0,13412329
20148048,베테랑,2015-08-05,2015-11-23,110 days 00:00:00.000000000,110,1,0.011,24,1,0.1,18,128,4.7,0.01,17,38000,105157247250,6,13412335
20148048,베테랑,2015-08-05,2015-11-24,111 days 00:00:00.000000000,111,2,0.023,22,1,0.1,21,256,3.5,0.01,20,66000,105157313250,9,13412344
20148048,베테랑,2015-08-05,2015-11-25,112 days 00:00:00.000000000,112,3,0.027000000000000003,15,3,0.1,14,288,79.9,0.01,19,1495000,105158808250,230,13412574
20148048,베테랑,2015-08-05,2015-11-26,113 days 00:00:00.000000000,113,1,0.009000000000000001,33,1,0.0,28,201,91.0,0.01,24,1281000,105160089250,183,13412757
20148048,베테랑,2015-08-05,2015-11-27,114 days 00:00:00.000000000,114,5,0.043,12,4,0.1,16,584,28.9,0.02,15,1030000,105161119250,169,13412926
20148048,베테랑,2015-08-05,2015-11-28,115 days 00:00:00.000000000,115,4,0.032,13,3,0.1,14,513,6.2,0.02,12,198000,105161317250,32,13412958
20148048,베테랑,2015-08-05,2015-11-29,116 days 00:00:00.000000000,116,2,0.017,18,2,0.1,16,252,8.7,0.01,17,139000,105161456250,22,13412980
20148048,베테랑,2015-08-05,2015-11-30,117 days 00:00:00.000000000,117,3,0.027000000000000003,21,3,0.1,16,319,3.5,0.01,21,71000,105161527250,11,13412991
20148048,베테랑,2015-08-05,2015-12-01,118 days 00:00:00.000000000,118,4,0.037000000000000005,17,3,0.1,16,522,3.6,0.02,16,107000,105161634250,19,13413010
20148048,베테랑,2015-08-05,2015-12-02,119 days 00:00:00.000000000,119,4,0.037000000000000005,16,3,0.1,15,504,3.0,0.02,15,94000,105161728250,15,13413025
20148048,베테랑,2015-08-05,2015-12-03,120 days 00:00:00.000000000,120,5,0.053,14,5,0.2,12,750,31.7,0.03,14,1553000,105163281250,238,13413263
20148048,베테랑,2015-08-05,2015-12-04,121 days 00:00:00.000000000,121,4,0.041,13,4,0.2,12,670,36.7,0.03,11,1706000,105164987250,246,13413509
20148048,베테랑,2015-08-05,2015-12-05,122 days 00:00:00.000000000,122,2,0.02,21,2,0.1,18,252,7.5,0.01,21,123000,105165110250,19,13413528
20148048,베테랑,2015-08-05,2015-12-06,123 days 00:00:00.000000000,123,2,0.02,21,2,0.1,18,252,5.2,0.01,21,82000,105165192250,13,13413541
20148048,베테랑,2015-08-05,2015-12-07,124 days 00:00:00.000000000,124,5,0.055,12,5,0.2,9,632,20.3,0.03,11,771000,105165963250,128,13413669
20148048,베테랑,2015-08-05,2015-12-08,125 days 00:00:00.000000000,125,5,0.055,12,5,0.2,11,669,1.5,0.03,16,64000,105166027250,10,13413679
20148048,베테랑,2015-08-05,2015-12-09,126 days 00:00:00.000000000,126,2,0.022,24,2,0.1,19,252,2.8,0.01,23,46000,105166073250,7,13413686
20148048,베테랑,2015-08-05,2015-12-10,127 days 00:00:00.000000000,127,2,0.024,20,2,0.1,18,261,2.3,0.01,20,32000,105166105250,6,13413692
20148048,베테랑,2015-08-05,2015-12-11,128 days 00:00:00.000000000,128,6,0.068,12,5,0.2,14,738,33.3,0.03,13,1598000,105167703250,246,13413938
20148048,베테랑,2015-08-05,2015-12-12,129 days 00:00:00.000000000,129,3,0.031,15,3,0.1,14,399,7.8,0.01,19,196000,105167899250,31,13413969
20148048,베테랑,2015-08-05,2015-12-13,130 days 00:00:00.000000000,130,2,0.021,17,2,0.1,15,252,6.0,0.01,16,104000,105168003250,15,13413984
20148048,베테랑,2015-08-05,2015-12-14,131 days 00:00:00.000000000,131,2,0.024,17,2,0.1,15,252,2.0,0.01,17,34000,105168037250,5,13413989
20148048,베테랑,2015-08-05,2015-12-15,132 days 00:00:00.000000000,132,4,0.047,17,4,0.1,16,513,2.7,0.02,17,84000,105168121250,14,13414003
20148048,베테랑,2015-08-05,2015-12-16,133 days 00:00:00.000000000,133,2,0.016,18,1,0.0,23,210,2.9,0.01,20,34000,105168155250,6,13414009
20148048,베테랑,2015-08-05,2016-03-28,236 days 00:00:00.000000000,236,2,0.071,15,2,0.2,9,278,11.2,0.01,15,190000,105168345250,31,13414040
20148048,베테랑,2015-08-05,2016-03-29,237 days 00:00:00.000000000,237,1,0.035,18,1,0.1,15,168,2.4,0.01,16,20000,105168365250,4,13414044
20148048,베테랑,2015-08-05,2016-03-31,239 days 00:00:00.000000000,239,2,0.053,15,2,0.1,15,206,4.9,0.01,14,68000,105168433250,10,13414054
20148048,베테랑,2015-08-05,2016-04-01,240 days 00:00:00.000000000,240,1,0.027000000000000003,19,1,0.1,18,152,54.0,0.01,15,490000,105168923250,82,13414136
20148048,베테랑,2015-08-05,2016-05-13,282 days 00:00:00.000000000,282,1,0.012,26,1,0.0,24,285,22.5,0.01,21,341000,105169264250,64,13414200
20148048,베테랑,2015-08-05,2016-06-01,301 days 00:00:00.000000000,301,1,0.012,24,1,0.0,21,256,0.0,0.01,20,0,105169264250,0,13414200
20148048,베테랑,2015-08-05,2016-07-02,332 days 00:00:00.000000000,332,1,0.01,21,1,0.0,19,168,0.0,0.01,15,0,105169264250,0,13414200
20148048,베테랑,2015-08-05,2019-10-18,1535 days 00:00:00.000000000,1535,34,0.436,12,34,1.3,11,4287,3.1,0.15,12,747000,105170011250,131,13414331
20148048,베테랑,2015-08-05,2019-10-19,1536 days 00:00:00.000000000,1536,11,0.14300000000000002,22,11,0.4,21,1653,2.5,0.05,16,240000,105170251250,41,13414372
20148048,베테랑,2015-08-05,2019-10-22,1539 days 00:00:00.000000000,1539,12,0.173,18,12,0.5,18,1282,4.0,0.05,18,281000,105170532250,51,13414423
20148048,베테랑,2015-08-05,2019-10-23,1540 days 00:00:00.000000000,1540,10,0.096,17,9,0.3,17,1297,4.7,0.05,14,324000,105170856250,61,13414484
